HOSPITAL_LOCATION_ID,PRODUCT_NUMBER,SUBSEQUENT_ORDER_QUANTITY,SUBSEQUENT_DELIVERY_QUANTITY,ORIGINAL_ORDER_QUANTITY,ORIGINAL_DELIVERY_QUANTITY,ENTRY_DATE,SUBSEQUENT_ORDER_DATE,LOST_QUANTITY,DAYS_BETWEEN_ORDERS
14.0,3029395,40,40,40,40,2022-12-07,2023-01-10,0,34
380.0,4226404,1,1,1,1,2023-01-05,2023-02-07,0,33
380.0,4907400,10,0,5,5,2023-01-05,2023-03-02,0,56
380.0,4907400,10,0,2,2,2023-02-07,2023-03-02,0,23
380.0,5480405,1,1,1,1,2023-01-05,2023-02-07,0,33
380.0,5482401,6,6,8,0,2023-02-07,2023-03-02,8,23
380.0,5488409,2,2,3,0,2023-02-07,2023-02-16,3,9
380.0,5488409,2,0,3,0,2023-02-07,2023-03-02,3,23
380.0,5488409,2,0,2,2,2023-02-16,2023-03-02,0,14
380.0,6179403,2,2,2,2,2023-01-05,2023-02-07,0,33
380.0,6179403,10,10,2,2,2023-01-05,2023-03-02,0,56
380.0,6179403,10,10,2,2,2023-02-07,2023-03-02,0,23
380.0,6598405,6,6,4,4,2023-02-07,2023-03-02,0,23
380.0,8717714,3,3,3,0,2023-02-07,2023-02-16,3,9
1192.0,8717714,1,1,1,1,2023-01-10,2023-01-27,0,17
1431.0,8720790,20,20,17,17,2023-01-24,2023-03-08,0,43
1431.0,1AA2581,6,6,6,6,2023-01-24,2023-02-02,0,9
2669.0,6598405,3,3,1,1,2023-01-05,2023-02-10,0,36
2780.0,6979407,3,3,3,0,2023-01-06,2023-01-19,3,13
3519.0,11403,7,7,2,2,2023-02-08,2023-03-17,0,37
3582.0,4907400,4,4,3,0,2023-02-27,2023-02-28,3,1
3582.0,5307401,15,0,15,0,2022-12-08,2023-01-11,15,34
3582.0,5307401,10,0,10,0,2023-02-27,2023-02-28,10,1
3582.0,5307401,10,0,15,0,2023-01-11,2023-02-27,15,47
3582.0,5307401,10,0,15,0,2023-01-11,2023-02-28,15,48
3582.0,5963336,7,7,7,0,2023-02-27,2023-02-28,7,1
3879.0,91488,5,5,5,5,2023-02-13,2023-03-28,0,43
3879.0,367012,5,5,3,3,2023-02-13,2023-02-28,0,15
3879.0,367012,4,4,3,3,2023-02-13,2023-03-28,0,43
3879.0,373019,2,2,2,2,2023-02-13,2023-02-28,0,15
3879.0,373019,4,4,2,2,2023-02-13,2023-03-28,0,43
3879.0,373019,4,4,2,2,2023-02-28,2023-03-28,0,28
3879.0,387028,4,4,2,2,2023-02-13,2023-03-28,0,43
3879.0,388018,1,1,1,1,2023-02-13,2023-02-28,0,15
3879.0,4520400,3,3,3,0,2023-02-28,2023-03-28,3,28
3879.0,4907400,10,10,4,4,2023-02-13,2023-03-28,0,43
3879.0,4907400,10,10,3,0,2023-02-28,2023-03-28,3,28
3879.0,5482401,24,24,24,24,2023-02-13,2023-02-28,0,15
3879.0,6598405,7,7,7,7,2023-02-13,2023-02-28,0,15
3879.0,6598405,8,8,7,7,2023-02-13,2023-03-28,0,43
3879.0,6598405,8,8,7,7,2023-02-28,2023-03-28,0,28
3879.0,6623400,6,6,6,6,2023-02-13,2023-03-28,0,43
3879.0,1AA0004,3,3,2,2,2023-02-13,2023-03-28,0,43
4648.0,91488,30,30,15,15,2023-01-04,2023-03-02,0,57
4975.0,5406,4,4,1,1,2023-03-01,2023-03-17,0,16
4975.0,5406,4,4,3,3,2023-01-26,2023-03-17,0,50
4975.0,173070,1,1,1,0,2023-03-17,2023-03-20,1,3
6143.0,8720774,2,2,2,0,2022-12-22,2023-01-11,2,20
6143.0,1AA0004,4,4,4,4,2022-12-22,2023-01-11,0,20
6810.0,97403,4,4,2,2,2023-02-20,2023-03-13,0,21
7905.0,91488,1,1,1,1,2023-01-10,2023-01-26,0,16
7905.0,5480405,10,10,10,10,2022-12-21,2023-01-24,0,34
7905.0,5480405,10,10,5,5,2023-01-05,2023-01-24,0,19
8545.0,97403,6,6,6,6,2022-12-22,2023-01-23,0,32
8545.0,97403,10,10,6,6,2023-01-23,2023-03-02,0,38
8545.0,1660407,4,4,3,3,2022-12-22,2023-01-23,0,32
8545.0,1660407,8,8,4,4,2023-01-23,2023-03-02,0,38
8545.0,5482401,8,8,8,8,2022-12-22,2023-01-23,0,32
8700.0,370023,2,2,2,0,2023-01-17,2023-01-27,2,10
8700.0,3029395,3,3,3,3,2023-01-17,2023-01-27,0,10
9598.0,387028,2,0,1,1,2022-12-15,2023-01-10,0,26
9598.0,387028,1,1,1,1,2022-12-15,2023-01-31,0,47
9598.0,387028,2,2,1,1,2022-12-15,2023-01-31,0,47
9598.0,387028,2,2,1,1,2022-12-15,2023-01-10,0,26
9598.0,387028,1,1,2,0,2023-01-10,2023-01-31,2,21
9598.0,387028,2,2,2,0,2023-01-10,2023-01-31,2,21
9598.0,387028,2,2,2,2,2023-01-10,2023-01-31,0,21
9684.0,727125,2,0,1,1,2023-01-10,2023-03-07,0,56
9684.0,8720790,20,20,15,15,2023-02-15,2023-03-09,0,22
9684.0,8720790,20,20,10,10,2023-03-03,2023-03-09,0,6
10361.0,5406,5,5,5,0,2023-02-27,2023-03-13,5,14
10361.0,34405,4,4,3,3,2022-12-29,2022-12-30,0,1
10361.0,1AA0003,4,4,3,3,2022-12-30,2023-02-27,0,59
11329.0,1AB2733,2,2,2,2,2023-02-14,2023-02-15,0,1
12263.0,97403,9,9,8,8,2022-11-23,2023-01-17,0,55
12263.0,97403,12,12,8,8,2022-11-23,2023-01-10,0,48
12263.0,367012,10,10,1,1,2022-11-23,2023-01-10,0,48
12263.0,6598405,10,10,10,10,2022-11-23,2023-01-17,0,55
12263.0,6623400,10,10,10,10,2022-11-23,2023-01-17,0,55
12427.0,365016,1,1,1,0,2023-02-24,2023-03-07,1,11
12464.0,504010,1,1,1,1,2023-01-11,2023-03-01,0,49
12464.0,505018,4,4,4,4,2023-01-11,2023-03-01,0,49
12464.0,5482401,3,3,8,0,2023-01-10,2023-03-01,8,50
12522.0,5406,5,5,1,1,2023-02-06,2023-03-23,0,45
12522.0,5406,4,4,1,1,2023-02-06,2023-03-20,0,42
12522.0,5406,5,5,4,4,2023-03-20,2023-03-23,0,3
12522.0,24406,3,3,5,0,2023-03-20,2023-03-23,5,3
12522.0,5482401,20,20,9,9,2023-03-20,2023-03-23,0,3
12890.0,97403,14,14,4,4,2023-01-17,2023-02-28,0,42
12890.0,5148409,14,14,14,14,2023-01-17,2023-02-28,0,42
13016.0,62349,3,3,3,3,2023-02-20,2023-02-27,0,7
14236.0,1402403,15,15,10,10,2023-01-19,2023-02-17,0,29
14481.0,91488,8,8,5,5,2022-12-27,2023-01-30,0,34
14481.0,97403,10,10,4,4,2023-01-30,2023-02-27,0,28
14481.0,367012,3,3,1,1,2023-01-30,2023-02-27,0,28
14481.0,374025,1,1,1,1,2022-12-27,2023-01-30,0,34
14481.0,4520400,2,2,2,2,2022-12-14,2022-12-27,0,13
14481.0,4520400,5,5,2,2,2022-12-14,2023-01-30,0,47
14481.0,4520400,5,5,2,2,2022-12-27,2023-01-30,0,34
14481.0,4907400,6,6,8,0,2022-12-27,2023-01-30,8,34
14481.0,5307401,5,0,8,0,2022-12-28,2023-01-11,8,14
14481.0,5307401,10,0,8,0,2022-12-28,2023-01-30,8,33
14481.0,5307401,8,0,8,0,2022-12-14,2022-12-28,8,14
14481.0,5307401,5,5,8,0,2022-12-14,2022-12-27,8,13
14481.0,5307401,10,0,8,0,2022-12-14,2022-12-27,8,13
14481.0,5307401,5,0,8,0,2022-12-14,2023-01-11,8,28
14481.0,5307401,10,0,8,0,2022-12-14,2023-01-30,8,47
14481.0,5307401,8,0,5,5,2022-12-27,2022-12-28,0,1
14481.0,5307401,5,0,5,5,2022-12-27,2023-01-11,0,15
14481.0,5307401,10,0,5,5,2022-12-27,2023-01-30,0,34
14481.0,5307401,8,0,10,0,2022-12-27,2022-12-28,10,1
14481.0,5307401,5,0,10,0,2022-12-27,2023-01-11,10,15
14481.0,5307401,10,0,10,0,2022-12-27,2023-01-30,10,34
14481.0,5307401,8,0,10,0,2022-12-14,2022-12-28,10,14
14481.0,5307401,5,5,10,0,2022-12-14,2022-12-27,10,13
14481.0,5307401,10,0,10,0,2022-12-14,2022-12-27,10,13
14481.0,5307401,5,0,10,0,2022-12-14,2023-01-11,10,28
14481.0,5307401,10,0,10,0,2022-12-14,2023-01-30,10,47
14481.0,5307401,10,0,5,0,2023-01-11,2023-01-30,5,19
14481.0,5307401,10,0,5,0,2023-01-11,2023-02-27,5,47
14481.0,5307401,10,0,10,0,2023-01-30,2023-02-27,10,28
14481.0,5482401,10,10,10,10,2023-01-30,2023-02-27,0,28
14481.0,6598405,10,10,8,8,2023-01-30,2023-02-27,0,28
14481.0,6623400,4,4,4,0,2022-12-27,2023-01-11,4,15
14481.0,6623400,4,4,4,0,2022-12-27,2023-01-30,4,34
14481.0,6623400,4,4,4,4,2023-01-11,2023-01-30,0,19
14578.0,91488,2,2,2,2,2023-01-12,2023-03-06,0,53
14578.0,97403,4,4,4,4,2023-01-12,2023-03-06,0,53
14578.0,6179403,2,2,2,2,2023-01-12,2023-03-06,0,53
14578.0,8720774,2,2,2,2,2023-01-12,2023-01-25,0,13
14578.0,8740012,10,10,2,2,2023-01-25,2023-03-06,0,40
14578.0,8740012,2,2,2,2,2023-01-12,2023-01-25,0,13
14578.0,8740012,10,10,2,2,2023-01-12,2023-03-06,0,53
14578.0,9511404,1,1,1,1,2023-01-12,2023-03-06,0,53
17104.0,62349,2,2,2,0,2023-02-17,2023-02-23,2,6
17363.0,91488,3,3,2,2,2022-12-28,2023-01-25,0,28
17363.0,91488,3,3,3,3,2023-01-25,2023-02-27,0,33
17363.0,91488,3,3,3,3,2023-01-25,2023-03-15,0,49
17363.0,91488,3,3,3,3,2023-02-27,2023-03-15,0,16
17363.0,4520400,2,2,1,1,2022-12-27,2023-02-02,0,37
17363.0,5480405,4,4,4,4,2022-12-27,2023-02-02,0,37
17363.0,5480405,5,5,4,4,2023-02-02,2023-02-27,0,25
18049.0,91488,2,2,2,2,2023-02-02,2023-03-08,0,34
18049.0,97403,2,2,2,2,2023-02-02,2023-03-08,0,34
18049.0,5148409,4,4,2,2,2023-02-02,2023-03-08,0,34
18049.0,5148409,4,4,2,2,2023-01-12,2023-03-08,0,55
18049.0,5148409,2,2,2,2,2023-01-12,2023-02-02,0,21
18049.0,5482401,2,2,2,2,2023-02-02,2023-03-08,0,34
18049.0,5482401,2,2,2,2,2023-01-12,2023-03-08,0,55
18049.0,5482401,2,2,2,2,2023-01-12,2023-02-02,0,21
18049.0,6598405,3,3,1,1,2023-01-12,2023-03-08,0,55
18241.0,97403,14,14,12,12,2022-12-27,2023-01-17,0,21
18424.0,504010,4,4,4,0,2023-01-10,2023-01-25,4,15
18424.0,504010,4,4,4,0,2023-01-10,2023-01-25,4,15
18424.0,505018,8,8,8,0,2023-01-10,2023-01-25,8,15
18424.0,505018,8,8,8,0,2023-01-10,2023-01-25,8,15
18578.0,246034,1,1,1,0,2023-02-07,2023-02-11,1,4
19059.0,5406,3,3,3,0,2023-02-28,2023-03-03,3,3
19059.0,390021,2,2,1,1,2023-01-30,2023-02-28,0,29
19059.0,1AB2190,1,1,1,0,2022-12-24,2023-01-30,1,37
20529.0,2128396,20,20,10,10,2022-12-07,2022-12-28,0,21
20968.0,829053,1,1,1,1,2023-02-15,2023-03-02,0,15
20968.0,830019,5,5,1,1,2023-02-15,2023-03-02,0,15
21679.0,504010,11,11,11,0,2023-02-24,2023-03-27,11,31
21679.0,505018,28,28,28,0,2023-02-24,2023-03-27,28,31
21840.0,505018,6,6,6,6,2023-02-01,2023-02-24,0,23
21978.0,311191,1,1,1,0,2022-12-29,2023-01-11,1,13
21978.0,355017,1,1,1,0,2022-12-29,2023-01-11,1,13
22140.0,8720774,2,2,2,0,2023-01-12,2023-02-13,2,32
23119.0,91488,6,6,6,6,2022-12-27,2023-02-13,0,48
23119.0,91488,6,6,2,2,2022-12-08,2022-12-27,0,19
23119.0,91488,10,10,6,6,2023-02-13,2023-03-13,0,28
23119.0,4907400,10,10,10,10,2023-02-13,2023-03-13,0,28
23119.0,5307401,6,0,4,0,2022-12-27,2023-01-20,4,24
23119.0,5307401,10,0,4,0,2022-12-27,2023-02-13,4,48
23119.0,5307401,7,0,4,0,2022-12-27,2023-02-14,4,49
23119.0,5307401,4,0,6,0,2022-12-08,2022-12-27,6,19
23119.0,5307401,6,0,6,0,2022-12-08,2023-01-20,6,43
23119.0,5307401,10,0,6,0,2023-01-20,2023-02-13,6,24
23119.0,5307401,7,0,6,0,2023-01-20,2023-02-14,6,25
23119.0,5307401,10,0,6,0,2023-01-20,2023-03-13,6,52
23119.0,5307401,7,0,10,0,2023-02-13,2023-02-14,10,1
23119.0,5307401,10,0,10,0,2023-02-13,2023-03-13,10,28
23119.0,5307401,10,0,7,0,2023-02-14,2023-03-13,7,27
23119.0,5482401,8,8,8,8,2023-02-13,2023-03-13,0,28
23119.0,6598405,5,0,5,5,2023-02-13,2023-03-13,0,28
23119.0,6598405,10,10,5,5,2023-02-13,2023-03-16,0,31
23119.0,6598405,10,10,5,0,2023-03-13,2023-03-16,5,3
23212.0,97403,3,3,2,2,2023-01-12,2023-02-03,0,22
23212.0,97403,5,5,3,3,2023-02-03,2023-03-16,0,41
23212.0,6598405,3,3,2,2,2023-01-12,2023-02-03,0,22
23896.0,504010,1,1,1,0,2023-03-02,2023-03-16,1,14
24081.0,91488,8,8,5,5,2022-12-13,2023-02-03,0,52
24081.0,372011,12,12,10,10,2022-12-13,2023-02-03,0,52
24081.0,390021,12,12,10,10,2022-12-13,2023-02-03,0,52
24081.0,9511404,8,8,8,8,2022-12-13,2023-02-03,0,52
24126.0,504010,4,4,2,2,2023-01-16,2023-02-17,0,32
24126.0,505018,8,8,6,6,2023-01-16,2023-02-17,0,32
24126.0,570094,1,1,1,1,2023-01-16,2023-02-17,0,32
24194.0,8720790,8,8,1,1,2022-12-05,2022-12-27,0,22
24280.0,91488,6,6,2,2,2023-01-16,2023-03-10,0,53
24280.0,1105403,6,6,6,6,2023-01-16,2023-03-10,0,53
24280.0,1240407,2,0,4,0,2023-01-16,2023-03-10,4,53
24280.0,1426585,1,1,1,1,2023-01-16,2023-03-10,0,53
24280.0,5482401,8,8,4,4,2023-01-16,2023-03-10,0,53
24972.0,526014,1,1,1,1,2022-12-22,2023-02-06,0,46
24972.0,535015,1,1,1,1,2022-12-22,2023-02-06,0,46
24972.0,541012,1,1,1,1,2022-12-22,2023-02-06,0,46
24972.0,544016,3,3,3,0,2022-12-22,2023-02-06,3,46
24972.0,545014,2,2,2,0,2022-12-22,2023-02-06,2,46
24972.0,546012,1,1,1,0,2022-12-22,2023-02-06,1,46
24972.0,547010,1,1,1,0,2022-12-22,2023-02-06,1,46
24972.0,556011,5,5,5,0,2022-12-22,2023-02-06,5,46
24972.0,557019,5,5,5,0,2022-12-22,2023-02-06,5,46
24972.0,559015,10,10,10,0,2022-12-22,2023-02-06,10,46
24972.0,631078,4,4,2,2,2022-12-22,2023-02-06,0,46
24972.0,631078,6,6,2,2,2022-12-22,2023-02-20,0,60
24972.0,631078,6,6,4,4,2023-02-06,2023-02-20,0,14
24972.0,631086,4,4,3,3,2022-12-22,2023-02-20,0,60
24972.0,661018,2,2,2,0,2022-12-22,2023-02-06,2,46
24972.0,662016,3,3,3,0,2022-12-22,2023-02-06,3,46
24972.0,663014,3,3,3,0,2022-12-22,2023-02-06,3,46
24972.0,666018,15,15,15,0,2022-12-22,2023-02-06,15,46
24972.0,692054,4,4,4,0,2022-12-22,2023-02-06,4,46
24972.0,795015,3,3,3,0,2022-12-22,2023-02-06,3,46
24972.0,9039059,2,2,2,0,2022-12-22,2023-02-06,2,46
25400.0,437047,1,0,1,1,2023-01-13,2023-02-14,0,32
25508.0,705014,1,1,1,0,2023-01-09,2023-01-30,1,21
25508.0,8740012,4,4,4,0,2023-01-09,2023-02-01,4,23
25594.0,89400,10,10,10,10,2023-01-13,2023-01-24,0,11
25594.0,367012,2,2,1,1,2023-01-13,2023-01-24,0,11
25594.0,5482401,5,0,10,0,2023-01-13,2023-01-24,10,11
25594.0,1AA0004,2,2,2,2,2023-01-13,2023-01-24,0,11
25594.0,1AB2691,2,2,2,2,2023-01-13,2023-01-24,0,11
25594.0,1AB2692,3,3,3,3,2023-01-13,2023-01-24,0,11
25840.0,8720774,2,2,2,0,2023-01-06,2023-02-15,2,40
25840.0,8720790,2,2,2,2,2023-01-06,2023-02-15,0,40
26014.0,571415,1,1,1,1,2023-02-08,2023-03-15,0,35
26024.0,91488,20,20,16,16,2023-01-05,2023-02-28,0,54
26455.0,89400,12,12,12,12,2023-01-16,2023-02-20,0,35
26455.0,89400,12,0,12,12,2023-01-16,2023-02-10,0,25
26455.0,89400,12,12,12,0,2023-02-10,2023-02-20,12,10
26455.0,367012,1,1,1,1,2023-01-16,2023-02-10,0,25
26455.0,4520400,3,3,2,2,2023-01-16,2023-02-10,0,25
26455.0,4520400,3,3,2,2,2023-01-16,2023-03-07,0,50
26455.0,4520400,3,3,3,3,2023-02-10,2023-03-07,0,25
26455.0,5307401,5,0,4,0,2023-01-20,2023-02-21,4,32
26455.0,5307401,4,0,4,0,2023-01-16,2023-01-20,4,4
26455.0,5307401,5,0,4,0,2023-01-16,2023-02-21,4,36
26455.0,5482401,6,6,6,6,2023-01-16,2023-02-10,0,25
26455.0,6598405,2,2,2,2,2023-01-16,2023-02-10,0,25
26455.0,6598405,4,4,2,2,2023-01-16,2023-03-07,0,50
26455.0,6598405,4,4,2,2,2023-02-10,2023-03-07,0,25
26922.0,504010,1,1,1,1,2023-01-04,2023-02-27,0,54
26922.0,505018,3,3,2,2,2023-01-04,2023-02-27,0,54
27118.0,1426585,2,2,2,0,2023-02-01,2023-02-08,2,7
27389.0,24406,2,2,2,2,2022-12-24,2023-02-22,0,60
27389.0,1240407,3,0,4,0,2022-12-24,2023-02-22,4,60
27389.0,5482401,10,10,2,2,2023-02-22,2023-03-08,0,14
27389.0,8717714,5,5,1,1,2022-12-24,2023-02-22,0,60
27423.0,62349,18,18,7,7,2022-12-27,2023-02-10,0,45
27425.0,8720790,10,10,7,7,2023-01-24,2023-02-23,0,30
27426.0,364026,19,19,3,3,2023-01-05,2023-03-02,0,56
27426.0,6623400,2,2,2,2,2023-01-05,2023-03-02,0,56
27531.0,504010,3,3,2,2,2023-01-03,2023-02-26,0,54
27531.0,505018,11,11,5,5,2023-01-03,2023-02-26,0,54
27537.0,504010,3,3,2,2,2023-02-16,2023-03-02,0,14
27537.0,505018,6,6,4,4,2023-02-16,2023-03-02,0,14
27645.0,91488,3,3,3,3,2022-12-27,2023-01-31,0,35
27645.0,91488,4,4,3,3,2023-01-31,2023-03-01,0,29
27645.0,5480405,8,8,2,2,2022-12-29,2023-02-13,0,46
27645.0,5480405,5,5,2,2,2022-12-29,2023-02-08,0,41
27645.0,5480405,8,8,5,5,2023-02-08,2023-02-13,0,5
27645.0,5482401,3,3,3,3,2023-01-31,2023-03-01,0,29
27653.0,91488,8,8,4,4,2023-01-16,2023-02-10,0,25
27653.0,233023,1,1,1,1,2023-01-16,2023-02-10,0,25
27653.0,3704138,10,10,6,6,2023-01-16,2023-02-10,0,25
27653.0,6598405,5,5,4,4,2023-01-16,2023-02-10,0,25
27807.0,25628,11,11,11,0,2022-12-14,2023-01-20,11,37
27807.0,25628,10,10,11,0,2022-12-14,2023-01-25,11,42
27807.0,91488,10,10,9,9,2022-12-02,2023-01-13,0,42
27807.0,91488,10,10,6,0,2023-01-03,2023-02-24,6,52
27807.0,91488,10,10,6,0,2023-01-03,2023-01-13,6,10
27807.0,91488,10,10,10,10,2023-01-13,2023-02-24,0,42
27807.0,97403,6,6,15,0,2023-01-03,2023-01-13,15,10
27807.0,97403,15,15,15,0,2023-01-03,2023-02-24,15,52
27807.0,97403,15,15,15,0,2023-01-03,2023-02-06,15,34
27807.0,97403,15,0,15,0,2023-01-03,2023-01-13,15,10
27807.0,97403,15,15,6,6,2023-01-13,2023-02-24,0,42
27807.0,97403,15,15,6,6,2023-01-13,2023-02-06,0,24
27807.0,97403,15,15,15,15,2023-02-06,2023-02-24,0,18
27807.0,97403,15,15,15,0,2023-01-13,2023-02-24,15,42
27807.0,97403,15,15,15,0,2023-01-13,2023-02-06,15,24
27807.0,309170,1,1,1,1,2023-01-03,2023-02-24,0,52
27807.0,309170,1,1,1,1,2023-01-03,2023-01-13,0,10
27807.0,309170,1,1,1,1,2023-01-13,2023-02-24,0,42
27807.0,365016,1,0,1,1,2023-01-03,2023-02-24,0,52
27807.0,365016,1,1,1,1,2023-01-03,2023-02-28,0,56
27807.0,365016,1,1,1,0,2023-02-24,2023-02-28,1,4
27807.0,373019,2,0,2,2,2023-01-03,2023-02-24,0,52
27807.0,373019,2,2,2,2,2023-01-03,2023-02-28,0,56
27807.0,373019,2,2,2,0,2023-02-24,2023-02-28,2,4
27807.0,374025,2,0,2,2,2023-01-03,2023-02-28,0,56
27807.0,374025,2,0,1,0,2023-02-24,2023-02-28,1,4
27807.0,378019,1,0,1,1,2023-01-03,2023-02-24,0,52
27807.0,378019,1,1,1,1,2023-01-03,2023-02-28,0,56
27807.0,378019,1,1,1,0,2023-02-24,2023-02-28,1,4
27807.0,387028,2,2,1,1,2023-01-03,2023-02-24,0,52
27807.0,387028,1,1,1,1,2023-01-03,2023-01-13,0,10
27807.0,387028,2,2,1,1,2023-01-13,2023-02-24,0,42
27807.0,387036,1,0,1,1,2023-01-03,2023-02-24,0,52
27807.0,387036,1,1,1,1,2023-01-03,2023-02-28,0,56
27807.0,387036,1,1,1,0,2023-02-24,2023-02-28,1,4
27807.0,388018,1,0,1,1,2023-01-03,2023-02-24,0,52
27807.0,388018,1,0,1,1,2023-01-03,2023-02-28,0,56
27807.0,388018,1,0,1,0,2023-02-24,2023-02-28,1,4
27807.0,2305135,19,19,8,8,2023-01-13,2023-02-24,0,42
27807.0,2305135,8,8,11,0,2023-01-03,2023-01-13,11,10
27807.0,2305135,19,19,11,0,2023-01-03,2023-02-24,11,52
27807.0,2305135,11,11,11,0,2023-01-03,2023-01-13,11,10
27807.0,2305135,19,19,11,11,2023-01-13,2023-02-24,0,42
27807.0,4520400,4,4,4,4,2023-01-03,2023-02-24,0,52
27807.0,5307401,30,0,20,0,2022-12-05,2022-12-14,20,9
27807.0,5307401,40,0,20,0,2022-12-05,2023-01-13,20,39
27807.0,5307401,50,0,20,0,2022-12-05,2023-01-03,20,29
27807.0,5307401,50,0,20,0,2022-12-05,2023-01-13,20,39
27807.0,5307401,4,0,20,0,2022-12-05,2023-01-27,20,53
27807.0,5307401,40,0,30,0,2022-12-14,2023-01-13,30,30
27807.0,5307401,50,0,30,0,2022-12-14,2023-01-03,30,20
27807.0,5307401,50,0,30,0,2022-12-14,2023-01-13,30,30
27807.0,5307401,4,0,30,0,2022-12-14,2023-01-27,30,44
27807.0,5307401,50,0,40,0,2023-01-13,2023-02-24,40,42
27807.0,5307401,50,0,40,0,2023-01-13,2023-02-28,40,46
27807.0,5307401,4,0,40,0,2023-01-13,2023-01-27,40,14
27807.0,5307401,40,0,50,0,2023-01-03,2023-01-13,50,10
27807.0,5307401,50,0,50,0,2023-01-03,2023-02-24,50,52
27807.0,5307401,50,0,50,0,2023-01-03,2023-01-13,50,10
27807.0,5307401,50,0,50,0,2023-01-03,2023-02-28,50,56
27807.0,5307401,4,0,50,0,2023-01-03,2023-01-27,50,24
27807.0,5307401,50,0,50,0,2023-02-24,2023-02-28,50,4
27807.0,5307401,50,0,50,0,2023-01-13,2023-02-24,50,42
27807.0,5307401,50,0,50,0,2023-01-13,2023-02-28,50,46
27807.0,5307401,4,0,50,0,2023-01-13,2023-01-27,50,14
27807.0,5307401,50,0,4,0,2023-01-27,2023-02-24,4,28
27807.0,5307401,50,0,4,0,2023-01-27,2023-02-28,4,32
27807.0,5482401,35,35,24,24,2023-01-03,2023-02-24,0,52
27807.0,5482401,35,35,1,1,2023-01-13,2023-02-24,0,42
27807.0,5482401,10,10,1,1,2023-01-13,2023-02-17,0,35
27807.0,5482401,35,35,10,10,2023-02-17,2023-02-24,0,7
27807.0,6598405,19,19,10,10,2023-01-03,2023-02-24,0,52
27807.0,6598405,10,10,10,10,2023-01-03,2023-01-13,0,10
27807.0,6598405,19,19,10,10,2023-01-13,2023-02-24,0,42
27807.0,6623400,10,10,10,10,2023-01-03,2023-02-24,0,52
28301.0,617011,2,2,1,1,2023-02-08,2023-03-21,0,41
28408.0,504010,4,4,2,2,2023-01-03,2023-01-12,0,9
28408.0,504010,3,3,2,2,2023-01-03,2023-02-13,0,41
28408.0,505018,8,8,4,4,2023-01-03,2023-01-12,0,9
28408.0,505018,6,6,4,4,2023-01-03,2023-02-13,0,41
28602.0,91488,3,3,2,0,2023-01-20,2023-02-24,2,35
28602.0,4520400,2,2,1,1,2023-01-20,2023-02-24,0,35
28602.0,5483409,2,2,2,2,2023-01-20,2023-02-24,0,35
28616.0,91488,2,2,2,2,2023-02-20,2023-03-22,0,30
28616.0,233023,1,1,1,1,2023-01-05,2023-01-25,0,20
28616.0,3704138,4,4,4,4,2023-01-25,2023-02-20,0,26
28616.0,5482401,10,10,10,10,2023-01-05,2023-02-20,0,46
28616.0,5482401,8,8,4,4,2023-01-25,2023-03-22,0,56
28616.0,5482401,10,10,4,4,2023-01-25,2023-02-20,0,26
28616.0,5488409,2,2,2,2,2023-02-20,2023-03-22,0,30
28669.0,14407,2,2,4,0,2023-01-30,2023-03-22,4,51
28669.0,4064408,2,2,2,0,2023-01-30,2023-03-22,2,51
28669.0,4520400,1,1,1,1,2023-01-30,2023-03-22,0,51
28669.0,5483409,2,2,2,0,2023-01-30,2023-03-22,2,51
28669.0,5483409,2,2,4,0,2023-01-30,2023-03-22,4,51
29164.0,5406,2,0,2,2,2023-01-10,2023-01-23,0,13
29164.0,11403,2,0,2,0,2023-01-10,2023-01-23,2,13
29164.0,97403,2,0,2,2,2023-01-10,2023-01-23,0,13
29164.0,365016,2,0,1,0,2023-01-10,2023-01-23,1,13
29164.0,367012,2,0,1,1,2023-01-10,2023-01-23,0,13
29164.0,369026,2,0,1,1,2023-01-10,2023-01-23,0,13
29164.0,9511404,2,0,2,2,2023-01-10,2023-01-23,0,13
29164.0,1AA0004,2,0,1,1,2023-01-10,2023-01-23,0,13
29300.0,91488,12,12,12,12,2023-01-06,2023-02-10,0,35
29300.0,2305135,14,14,10,10,2023-01-06,2023-02-28,0,53
29300.0,2305135,14,14,10,10,2023-01-06,2023-02-10,0,35
29300.0,2305135,14,14,4,4,2023-01-06,2023-02-28,0,53
29300.0,2305135,14,14,4,4,2023-01-06,2023-02-10,0,35
29300.0,2305135,14,14,14,14,2023-02-10,2023-02-28,0,18
29300.0,4907400,20,20,17,17,2023-02-21,2023-02-28,0,7
29300.0,4907400,20,20,20,20,2023-01-06,2023-02-28,0,53
29300.0,4907400,20,20,3,3,2023-02-10,2023-02-28,0,18
29300.0,4907400,17,17,3,3,2023-02-10,2023-02-21,0,11
29300.0,5482401,20,20,5,5,2022-12-19,2023-01-06,0,18
29300.0,5482401,20,20,5,5,2022-12-19,2023-02-10,0,53
29300.0,5482401,5,5,5,5,2023-02-28,2023-03-04,0,4
29300.0,5482401,20,20,20,20,2023-01-06,2023-02-10,0,35
29431.0,91488,5,5,3,3,2023-02-14,2023-03-16,0,30
29431.0,6598405,12,12,12,12,2023-02-01,2023-02-14,0,13
29431.0,6598405,12,12,8,8,2023-02-01,2023-02-14,0,13
29726.0,91488,12,12,12,0,2022-11-29,2023-01-11,12,43
29726.0,91488,8,8,12,0,2022-11-29,2023-01-09,12,41
29726.0,91488,12,12,8,8,2023-01-09,2023-01-11,0,2
29726.0,91488,10,10,8,8,2023-01-09,2023-02-27,0,49
29726.0,97403,8,8,8,8,2022-11-29,2023-01-09,0,41
29726.0,97403,20,20,8,8,2023-01-09,2023-02-27,0,49
29726.0,233023,4,4,4,4,2023-01-09,2023-02-27,0,49
29726.0,233023,4,4,4,4,2023-02-27,2023-03-22,0,23
29726.0,365016,1,1,1,1,2023-02-27,2023-03-22,0,23
29726.0,367012,1,1,1,1,2023-01-09,2023-02-27,0,49
29726.0,367012,1,1,1,1,2023-02-27,2023-03-22,0,23
29726.0,373019,1,1,1,1,2023-01-09,2023-02-27,0,49
29726.0,378019,1,1,1,1,2023-01-09,2023-02-27,0,49
29726.0,378019,1,1,1,1,2023-02-27,2023-03-22,0,23
29726.0,387028,2,2,2,2,2023-01-09,2023-02-27,0,49
29726.0,387028,2,2,2,2,2023-02-27,2023-03-22,0,23
29726.0,1676404,8,8,6,6,2023-01-20,2023-03-09,0,48
29726.0,1676404,8,8,6,6,2023-01-20,2023-01-27,0,7
29726.0,1676404,10,10,6,6,2023-01-20,2023-03-13,0,52
29726.0,1676404,10,10,8,8,2023-03-09,2023-03-13,0,4
29726.0,1676404,10,10,8,8,2023-03-09,2023-03-22,0,13
29726.0,1676404,8,8,8,8,2023-01-27,2023-03-09,0,41
29726.0,1676404,10,10,8,8,2023-01-27,2023-03-13,0,45
29726.0,1676404,10,10,8,8,2023-01-27,2023-03-22,0,54
29726.0,1676404,6,6,2,2,2023-01-12,2023-01-20,0,8
29726.0,1676404,8,8,2,2,2023-01-12,2023-03-09,0,56
29726.0,1676404,8,8,2,2,2023-01-12,2023-01-27,0,15
29726.0,1676404,10,10,2,2,2023-01-12,2023-03-13,0,60
29726.0,1676404,10,10,10,10,2023-03-13,2023-03-22,0,9
29726.0,2305135,5,5,5,5,2023-02-27,2023-03-22,0,23
29726.0,5307401,4,4,12,0,2022-11-15,2022-12-05,12,20
29726.0,5307401,14,0,12,0,2022-11-15,2022-11-29,12,14
29726.0,5307401,14,0,12,0,2022-11-15,2023-01-11,12,57
29726.0,5307401,2,0,12,0,2022-11-15,2023-01-09,12,55
29726.0,5307401,2,0,12,0,2022-11-15,2023-01-12,12,58
29726.0,5307401,14,0,4,4,2022-12-05,2023-01-11,0,37
29726.0,5307401,14,0,4,4,2022-12-05,2023-01-20,0,46
29726.0,5307401,8,0,4,4,2022-12-05,2023-01-27,0,53
29726.0,5307401,4,4,14,0,2022-11-29,2022-12-05,14,6
29726.0,5307401,14,0,14,0,2022-11-29,2023-01-11,14,43
29726.0,5307401,2,0,14,0,2022-11-29,2023-01-09,14,41
29726.0,5307401,14,0,14,0,2022-11-29,2023-01-20,14,52
29726.0,5307401,8,0,14,0,2022-11-29,2023-01-27,14,59
29726.0,5307401,2,0,14,0,2022-11-29,2023-01-12,14,44
29726.0,5307401,10,0,14,0,2023-01-11,2023-02-27,14,47
29726.0,5307401,14,0,14,0,2023-01-11,2023-01-20,14,9
29726.0,5307401,8,0,14,0,2023-01-11,2023-01-27,14,16
29726.0,5307401,2,0,14,0,2023-01-11,2023-01-12,14,1
29726.0,5307401,14,0,2,0,2023-01-09,2023-01-11,2,2
29726.0,5307401,10,0,2,0,2023-01-09,2023-02-27,2,49
29726.0,5307401,14,0,2,0,2023-01-09,2023-01-20,2,11
29726.0,5307401,8,0,2,0,2023-01-09,2023-01-27,2,18
29726.0,5307401,2,0,2,0,2023-01-09,2023-01-12,2,3
29726.0,5307401,10,0,14,0,2023-01-20,2023-02-27,14,38
29726.0,5307401,8,0,14,0,2023-01-20,2023-01-27,14,7
29726.0,5307401,10,0,8,0,2023-01-27,2023-02-27,8,31
29726.0,5307401,10,0,2,0,2023-01-12,2023-02-27,2,46
29726.0,5307401,14,0,2,0,2023-01-12,2023-01-20,2,8
29726.0,5307401,8,0,2,0,2023-01-12,2023-01-27,2,15
29726.0,5482401,16,16,16,16,2022-11-29,2023-01-09,0,41
29726.0,5482401,16,16,16,16,2023-01-09,2023-02-27,0,49
29726.0,6598405,12,12,10,10,2022-11-29,2023-01-09,0,41
29726.0,6623400,8,8,8,8,2022-11-29,2023-01-09,0,41
29726.0,1AA0004,3,3,2,2,2023-01-09,2023-02-27,0,49
29902.0,504010,4,4,3,3,2022-12-29,2023-02-26,0,59
29902.0,504010,4,4,2,2,2023-01-25,2023-02-26,0,32
29902.0,505018,8,8,7,7,2022-12-29,2023-02-26,0,59
29902.0,505018,8,8,4,4,2023-01-25,2023-02-26,0,32
29929.0,1AA0003,1,1,1,0,2023-01-24,2023-01-31,1,7
29929.0,1AA0004,3,3,3,0,2023-01-24,2023-01-31,3,7
29944.0,5406,6,6,6,6,2023-01-25,2023-01-26,0,1
29944.0,372011,3,0,3,0,2023-01-25,2023-01-26,3,1
30092.0,14407,4,4,4,0,2023-01-05,2023-02-15,4,41
30092.0,45626,4,4,4,0,2023-01-05,2023-02-15,4,41
30092.0,48406,2,2,2,0,2023-01-05,2023-02-15,2,41
30092.0,91488,3,3,3,0,2023-01-05,2023-02-15,3,41
30092.0,97403,2,2,2,0,2023-01-05,2023-02-15,2,41
30092.0,3029395,2,2,2,0,2023-01-05,2023-02-15,2,41
30092.0,4520400,2,2,2,0,2023-01-05,2023-02-15,2,41
30092.0,4608404,2,2,2,0,2023-01-05,2023-02-15,2,41
30092.0,5482401,10,10,10,0,2023-01-05,2023-02-15,10,41
30092.0,5483409,1,1,1,0,2023-01-05,2023-02-15,1,41
30092.0,8720790,4,4,4,0,2023-01-05,2023-02-15,4,41
30092.0,9511404,1,1,1,0,2023-01-05,2023-02-15,1,41
30172.0,6255096,3,3,1,1,2023-01-18,2023-01-20,0,2
30172.0,6623400,10,10,4,4,2023-01-18,2023-03-17,0,58
30419.0,5307401,10,0,10,0,2023-01-25,2023-02-02,10,8
30708.0,919011,3,3,2,2,2023-01-16,2023-02-22,0,37
31363.0,91488,6,6,6,6,2022-12-29,2023-02-24,0,57
31363.0,1676404,6,6,3,3,2023-01-18,2023-02-24,0,37
31363.0,1676404,6,6,3,3,2023-01-18,2023-02-01,0,14
31363.0,1676404,3,3,3,3,2023-01-18,2023-03-03,0,44
31363.0,1676404,6,6,2,2,2023-01-26,2023-02-24,0,29
31363.0,1676404,6,6,2,2,2023-01-26,2023-02-01,0,6
31363.0,1676404,3,3,2,2,2023-01-26,2023-03-03,0,36
31363.0,1676404,6,6,6,6,2023-02-01,2023-02-24,0,23
31363.0,2305135,8,8,6,6,2022-12-29,2023-02-01,0,34
31363.0,2305135,8,8,6,6,2022-12-29,2023-02-24,0,57
31363.0,2305135,8,8,8,8,2023-02-01,2023-02-24,0,23
31363.0,3704138,8,8,6,6,2023-01-12,2023-01-31,0,19
31363.0,4520400,2,2,2,2,2022-12-29,2023-01-03,0,5
31363.0,4520400,3,3,2,2,2022-12-29,2023-02-24,0,57
31363.0,4520400,3,3,2,2,2023-01-03,2023-02-24,0,52
31363.0,5307401,6,0,6,0,2022-12-02,2022-12-29,6,27
31363.0,5307401,6,0,6,0,2022-12-02,2023-01-03,6,32
31363.0,5307401,6,0,6,0,2022-12-02,2023-01-18,6,47
31363.0,5307401,2,0,6,0,2022-12-02,2023-01-26,6,55
31363.0,5307401,6,0,6,0,2022-12-29,2023-02-01,6,34
31363.0,5307401,6,0,6,0,2022-12-29,2023-01-03,6,5
31363.0,5307401,6,0,6,0,2022-12-29,2023-02-24,6,57
31363.0,5307401,6,0,6,0,2022-12-29,2023-01-18,6,20
31363.0,5307401,2,0,6,0,2022-12-29,2023-01-26,6,28
31363.0,5307401,6,0,6,0,2022-12-29,2023-02-24,6,57
31363.0,5307401,6,0,6,0,2022-12-29,2023-02-01,6,34
31363.0,5307401,6,0,6,0,2023-02-01,2023-02-24,6,23
31363.0,5307401,6,0,6,0,2023-02-01,2023-02-24,6,23
31363.0,5307401,6,0,6,0,2023-01-03,2023-02-01,6,29
31363.0,5307401,6,0,6,0,2023-01-03,2023-02-24,6,52
31363.0,5307401,6,0,6,0,2023-01-03,2023-01-18,6,15
31363.0,5307401,2,0,6,0,2023-01-03,2023-01-26,6,23
31363.0,5307401,6,0,6,0,2023-01-03,2023-02-24,6,52
31363.0,5307401,6,0,6,0,2023-01-03,2023-02-01,6,29
31363.0,5307401,6,0,6,0,2023-01-18,2023-02-01,6,14
31363.0,5307401,6,0,6,0,2023-01-18,2023-02-24,6,37
31363.0,5307401,2,0,6,0,2023-01-18,2023-01-26,6,8
31363.0,5307401,6,0,6,0,2023-01-18,2023-02-24,6,37
31363.0,5307401,6,0,6,0,2023-01-18,2023-02-01,6,14
31363.0,5307401,6,0,2,0,2023-01-26,2023-02-01,2,6
31363.0,5307401,6,0,2,0,2023-01-26,2023-02-24,2,29
31363.0,5307401,6,0,2,0,2023-01-26,2023-02-24,2,29
31363.0,5307401,6,0,2,0,2023-01-26,2023-02-01,2,6
31363.0,5307401,6,0,6,0,2023-02-01,2023-02-24,6,23
31363.0,5307401,6,0,6,0,2023-02-01,2023-02-24,6,23
31363.0,5482401,8,8,8,8,2023-02-01,2023-02-24,0,23
31363.0,6598405,10,10,7,7,2022-12-29,2023-02-01,0,34
31363.0,6598405,20,20,7,7,2022-12-29,2023-02-24,0,57
31363.0,6598405,20,20,10,10,2023-02-01,2023-02-24,0,23
31363.0,6623400,4,4,4,4,2022-12-29,2023-02-01,0,34
31363.0,6623400,5,5,4,4,2022-12-29,2023-02-24,0,57
31363.0,6623400,5,5,4,4,2023-02-01,2023-02-24,0,23
31510.0,57407,16,16,4,4,2022-12-19,2023-01-31,0,43
31510.0,91488,45,45,10,10,2023-02-20,2023-02-28,0,8
31612.0,504010,3,3,3,3,2023-02-20,2023-03-21,0,29
31612.0,504010,3,3,7,0,2023-02-07,2023-02-20,7,13
31612.0,504010,3,3,7,0,2023-02-07,2023-03-21,7,42
31612.0,504010,3,3,8,0,2023-02-07,2023-02-20,8,13
31612.0,504010,3,3,8,0,2023-02-07,2023-03-21,8,42
31612.0,505018,6,6,6,6,2023-02-20,2023-03-21,0,29
31612.0,505018,6,6,1,0,2023-02-07,2023-02-20,1,13
31612.0,505018,6,6,1,0,2023-02-07,2023-03-21,1,42
31738.0,97403,1,1,1,1,2023-01-09,2023-02-27,0,49
31738.0,8720790,1,1,1,1,2023-01-03,2023-01-25,0,22
31738.0,8720790,2,2,1,1,2023-01-03,2023-01-09,0,6
31786.0,1402403,30,30,30,30,2023-01-23,2023-03-09,0,45
31925.0,504010,2,2,3,0,2023-02-01,2023-02-16,3,15
31925.0,504010,3,0,7,0,2023-01-25,2023-02-01,7,7
31925.0,504010,2,2,7,0,2023-01-25,2023-02-16,7,22
31925.0,504010,3,0,4,0,2023-01-13,2023-02-01,4,19
31925.0,504010,2,2,4,0,2023-01-13,2023-02-16,4,34
31925.0,504010,7,7,4,0,2023-01-13,2023-01-25,4,12
31925.0,504010,7,0,4,0,2023-01-13,2023-01-25,4,12
31925.0,504010,7,7,4,4,2023-01-13,2023-01-25,0,12
31925.0,504010,7,0,4,4,2023-01-13,2023-01-25,0,12
31925.0,505018,6,6,2,2,2023-02-01,2023-02-16,0,15
31925.0,505018,2,2,10,0,2023-01-25,2023-02-01,10,7
31925.0,505018,6,6,10,0,2023-01-25,2023-02-16,10,22
31925.0,505018,2,2,6,0,2023-01-13,2023-02-01,6,19
31925.0,505018,6,6,6,0,2023-01-13,2023-02-16,6,34
31925.0,505018,8,8,6,0,2023-01-13,2023-01-25,6,12
31925.0,505018,10,0,6,0,2023-01-13,2023-01-25,6,12
31925.0,505018,6,6,6,6,2023-01-13,2023-02-16,0,34
31925.0,505018,8,8,6,6,2023-01-13,2023-01-25,0,12
31925.0,505018,10,0,6,6,2023-01-13,2023-01-25,0,12
31925.0,570094,1,1,1,1,2023-01-25,2023-02-01,0,7
31925.0,634056,6,6,6,0,2023-02-16,2023-02-17,6,1
31971.0,504010,2,2,2,2,2023-01-05,2023-02-02,0,28
31971.0,504010,2,2,2,0,2023-01-02,2023-01-05,2,3
31971.0,504010,2,2,2,0,2023-01-02,2023-02-02,2,31
31971.0,505018,2,2,2,0,2023-01-02,2023-01-05,2,3
31995.0,91488,5,5,5,5,2023-03-13,2023-03-22,0,9
31995.0,4907400,15,15,10,10,2023-03-13,2023-03-22,0,9
32117.0,504010,4,4,2,0,2023-01-09,2023-02-17,2,39
32117.0,504010,4,0,2,0,2023-01-09,2023-02-17,2,39
32117.0,504010,4,4,2,2,2023-01-09,2023-02-17,0,39
32117.0,504010,4,0,2,2,2023-01-09,2023-02-17,0,39
32117.0,504010,4,4,4,4,2023-02-17,2023-03-29,0,40
32117.0,504010,4,4,4,0,2023-02-17,2023-03-29,4,40
32117.0,505018,9,0,4,4,2023-01-09,2023-02-17,0,39
32117.0,505018,9,9,4,4,2023-01-09,2023-02-17,0,39
32117.0,505018,9,0,4,0,2023-01-09,2023-02-17,4,39
32117.0,505018,9,9,4,0,2023-01-09,2023-02-17,4,39
32192.0,8720790,2,2,2,0,2023-01-24,2023-02-27,2,34
32478.0,97403,12,12,8,8,2023-01-03,2023-02-21,0,49
32479.0,97403,15,15,10,10,2023-02-09,2023-03-23,0,42
32804.0,57407,8,8,8,8,2023-01-04,2023-02-07,0,34
32804.0,5148409,12,12,12,12,2023-01-04,2023-02-07,0,34
32804.0,5482401,8,8,8,8,2023-01-04,2023-02-07,0,34
32912.0,504010,2,2,1,1,2023-01-17,2023-01-19,0,2
32912.0,505018,3,3,3,3,2023-01-17,2023-01-19,0,2
33119.0,5482401,3,3,3,3,2023-01-09,2023-02-16,0,38
33320.0,225012,2,2,1,1,2022-12-15,2023-01-30,0,46
33320.0,367012,3,3,2,2,2022-12-15,2023-01-30,0,46
33320.0,2306265,6,6,6,6,2023-02-16,2023-03-09,0,21
33359.0,505018,13,13,13,0,2022-12-21,2023-02-14,13,55
33528.0,5480405,10,10,5,5,2022-12-29,2023-02-03,0,36
33528.0,5480405,5,5,5,5,2022-12-29,2023-02-01,0,34
33528.0,5480405,10,10,5,5,2023-02-01,2023-02-03,0,2
33528.0,5480405,7,7,5,5,2023-02-01,2023-03-23,0,50
33534.0,5482401,3,3,2,2,2022-12-28,2023-02-24,0,58
33549.0,6598405,4,4,3,3,2023-01-02,2023-02-15,0,44
33649.0,48406,2,2,1,1,2022-12-22,2023-01-30,0,39
33649.0,97403,3,3,3,3,2022-12-22,2023-01-30,0,39
33649.0,4064408,2,2,1,0,2022-12-22,2023-01-30,1,39
33649.0,5482401,5,5,3,3,2022-12-22,2023-01-30,0,39
33813.0,504010,2,2,2,0,2023-01-11,2023-03-08,2,56
33813.0,631078,5,5,5,0,2023-01-11,2023-03-08,5,56
33813.0,662016,2,2,2,0,2023-01-11,2023-03-08,2,56
33813.0,663014,1,1,1,0,2023-01-11,2023-03-08,1,56
33813.0,707010,2,2,2,0,2023-01-11,2023-03-08,2,56
33904.0,1402403,5,5,2,2,2023-02-27,2023-03-23,0,24
33904.0,1412402,6,6,2,2,2023-02-27,2023-03-23,0,24
33904.0,5482401,4,4,4,4,2023-02-27,2023-03-23,0,24
33904.0,1AB2735,5,5,6,0,2023-02-27,2023-03-23,6,24
33925.0,1401405,15,0,2,0,2023-01-04,2023-02-23,2,50
33939.0,1676404,15,15,15,0,2023-03-03,2023-03-16,15,13
33939.0,1676404,15,0,10,10,2023-01-11,2023-03-03,0,51
33939.0,1676404,10,10,10,10,2023-01-11,2023-02-15,0,35
33939.0,1676404,23,23,10,10,2023-01-11,2023-03-03,0,51
33939.0,1676404,15,0,10,10,2023-02-15,2023-03-03,0,16
33939.0,1676404,23,23,10,10,2023-02-15,2023-03-03,0,16
33939.0,1676404,15,15,10,10,2023-02-15,2023-03-16,0,29
33939.0,1676404,15,0,6,6,2023-02-01,2023-03-03,0,30
33939.0,1676404,10,10,6,6,2023-02-01,2023-02-15,0,14
33939.0,1676404,23,23,6,6,2023-02-01,2023-03-03,0,30
33939.0,1676404,15,15,6,6,2023-02-01,2023-03-16,0,43
33939.0,2305135,33,33,30,30,2023-02-01,2023-03-03,0,30
33939.0,2305135,33,33,13,13,2023-02-27,2023-03-03,0,4
33939.0,5307401,15,0,10,0,2023-02-01,2023-02-27,10,26
33939.0,5307401,10,0,10,0,2023-02-01,2023-02-15,10,14
33939.0,5307401,10,0,10,0,2023-01-23,2023-02-01,10,9
33939.0,5307401,15,0,10,0,2023-01-23,2023-02-27,10,35
33939.0,5307401,10,0,10,0,2023-01-23,2023-02-01,10,9
33939.0,5307401,10,0,10,0,2023-01-23,2023-01-26,10,3
33939.0,5307401,10,0,10,0,2023-01-23,2023-02-15,10,23
33939.0,5307401,6,0,10,0,2023-01-23,2023-02-01,10,9
33939.0,5307401,15,0,10,0,2023-02-01,2023-02-27,10,26
33939.0,5307401,10,0,10,0,2023-02-01,2023-02-15,10,14
33939.0,5307401,10,0,10,0,2023-01-26,2023-02-01,10,6
33939.0,5307401,15,0,10,0,2023-01-26,2023-02-27,10,32
33939.0,5307401,10,0,10,0,2023-01-26,2023-02-01,10,6
33939.0,5307401,10,0,10,0,2023-01-26,2023-02-15,10,20
33939.0,5307401,6,0,10,0,2023-01-26,2023-02-01,10,6
33939.0,5307401,10,0,33,0,2023-01-11,2023-02-01,33,21
33939.0,5307401,10,0,33,0,2023-01-11,2023-01-23,33,12
33939.0,5307401,15,0,33,0,2023-01-11,2023-02-27,33,47
33939.0,5307401,10,0,33,0,2023-01-11,2023-02-01,33,21
33939.0,5307401,10,0,33,0,2023-01-11,2023-01-26,33,15
33939.0,5307401,10,0,33,0,2023-01-11,2023-02-15,33,35
33939.0,5307401,6,0,33,0,2023-01-11,2023-02-01,33,21
33939.0,5307401,15,0,10,0,2023-02-15,2023-02-27,10,12
33939.0,5307401,15,0,6,0,2023-02-01,2023-02-27,6,26
33939.0,5307401,10,0,6,0,2023-02-01,2023-02-15,6,14
33939.0,5482401,10,10,8,8,2023-02-01,2023-02-27,0,26
33939.0,6598405,12,12,5,5,2023-02-01,2023-02-27,0,26
33939.0,6598405,12,12,7,7,2023-02-01,2023-02-27,0,26
33939.0,1AA0004,2,2,2,2,2023-01-23,2023-02-27,0,35
34004.0,97403,8,8,6,6,2023-01-23,2023-03-20,0,56
34004.0,6598405,2,2,1,1,2023-01-23,2023-03-20,0,56
34004.0,8720790,1,1,1,1,2023-01-23,2023-03-20,0,56
34076.0,97403,12,12,10,10,2022-12-12,2023-01-30,0,49
34076.0,5482401,8,8,4,4,2022-12-07,2023-01-27,0,51
34076.0,6598405,12,12,8,8,2022-12-12,2023-01-30,0,49
34076.0,6623400,6,6,4,4,2022-12-12,2023-01-30,0,49
34098.0,97403,8,8,6,6,2022-12-20,2023-01-17,0,28
34098.0,1660407,6,6,3,3,2022-12-20,2023-01-17,0,28
34098.0,5482427,2,2,2,2,2023-01-17,2023-02-22,0,36
34098.0,6598405,6,6,6,6,2022-12-20,2023-01-17,0,28
34099.0,725012,4,4,4,0,2023-01-16,2023-01-17,4,1
34099.0,727265,16,16,16,16,2023-02-13,2023-03-20,0,35
34099.0,727265,16,16,16,16,2023-01-09,2023-02-13,0,35
34192.0,6519427,5,5,5,5,2023-01-05,2023-01-27,0,22
34734.0,505018,13,13,12,0,2023-01-30,2023-03-27,12,56
34734.0,505018,14,14,12,0,2023-01-30,2023-03-08,12,37
34734.0,505018,13,13,12,12,2023-01-30,2023-03-27,0,56
34734.0,505018,14,14,12,12,2023-01-30,2023-03-08,0,37
34826.0,91488,4,0,4,4,2023-01-09,2023-02-14,0,36
34826.0,91488,4,4,4,4,2023-01-09,2023-03-09,0,59
34826.0,91488,4,4,4,0,2023-02-14,2023-03-09,4,23
34826.0,5482401,7,7,4,4,2023-01-09,2023-02-14,0,36
34826.0,5482401,4,4,4,4,2023-01-09,2023-03-09,0,59
34864.0,246034,1,1,2,0,2022-12-28,2023-01-27,2,30
34864.0,390021,5,5,4,4,2022-12-28,2023-01-27,0,30
34864.0,390021,7,7,4,4,2022-12-28,2023-01-27,0,30
34864.0,6255096,1,0,2,0,2022-12-28,2023-01-27,2,30
34864.0,6255096,1,1,2,0,2022-12-28,2023-01-27,2,30
34864.0,6444095,1,1,2,0,2022-12-28,2023-01-27,2,30
35051.0,89400,6,6,6,6,2023-01-24,2023-03-13,0,48
35061.0,526014,1,1,2,0,2023-01-19,2023-03-08,2,48
35061.0,661018,2,2,3,0,2023-01-19,2023-03-08,3,48
35183.0,5482401,15,15,10,10,2023-03-08,2023-03-23,0,15
35210.0,5307401,8,0,8,0,2022-12-13,2023-01-24,8,42
35210.0,5307401,8,0,8,0,2022-12-13,2023-01-03,8,21
35210.0,5307401,4,0,8,0,2022-12-13,2023-01-27,8,45
35210.0,5307401,8,0,8,0,2022-12-13,2023-01-27,8,45
35210.0,5307401,4,0,8,0,2023-01-24,2023-01-27,8,3
35210.0,5307401,8,0,8,0,2023-01-24,2023-01-27,8,3
35210.0,5307401,8,0,8,0,2023-01-03,2023-01-24,8,21
35210.0,5307401,4,0,8,0,2023-01-03,2023-01-27,8,24
35210.0,5307401,8,0,8,0,2023-01-03,2023-01-27,8,24
35210.0,5482401,10,10,10,10,2022-12-13,2023-01-24,0,42
35210.0,6598405,10,10,10,10,2022-12-13,2023-01-24,0,42
35210.0,6623400,10,10,5,5,2022-12-13,2023-01-24,0,42
35292.0,91488,5,5,5,5,2022-12-15,2023-02-02,0,49
35292.0,91488,5,5,5,5,2023-02-02,2023-03-01,0,27
35292.0,97403,6,6,6,6,2023-01-09,2023-02-16,0,38
35292.0,1660407,3,3,2,2,2023-02-02,2023-02-16,0,14
35292.0,5480405,6,6,6,6,2023-01-18,2023-01-23,0,5
35292.0,5480405,4,4,4,4,2023-02-24,2023-03-02,0,6
35292.0,5482401,5,5,3,3,2022-12-15,2023-02-02,0,49
35426.0,57407,10,10,6,6,2023-01-30,2023-03-07,0,36
35426.0,8740012,3,3,1,1,2023-01-09,2023-01-30,0,21
35565.0,62349,5,5,3,3,2023-01-25,2023-03-02,0,36
35565.0,89400,11,11,6,6,2023-01-25,2023-03-02,0,36
35565.0,89400,7,7,6,6,2023-01-25,2023-03-24,0,58
35565.0,91488,10,10,8,8,2023-01-16,2023-03-09,0,52
35565.0,91488,10,10,8,8,2023-01-16,2023-02-15,0,30
35565.0,91488,10,10,10,10,2023-02-15,2023-03-09,0,22
35565.0,233023,4,4,2,2,2023-01-25,2023-03-02,0,36
35565.0,4520400,2,2,1,1,2023-03-02,2023-03-24,0,22
35565.0,4907400,10,10,10,10,2023-03-02,2023-03-24,0,22
35565.0,1AA0004,3,3,1,1,2023-01-25,2023-03-02,0,36
35565.0,1AA0004,1,1,1,1,2023-01-25,2023-03-24,0,58
35565.0,1AB2692,2,2,2,2,2023-01-25,2023-03-02,0,36
35681.0,1AA8981,2,2,1,1,2023-02-13,2023-03-17,0,32
35681.0,1AA8981,2,2,3,0,2023-02-06,2023-03-17,3,39
35681.0,1AA8981,1,1,3,0,2023-02-06,2023-02-13,3,7
35739.0,48406,1,1,1,1,2023-01-29,2023-03-21,0,51
35836.0,1412402,4,0,4,4,2023-02-06,2023-02-09,0,3
35886.0,246117,1,1,1,0,2023-02-11,2023-03-21,1,38
35886.0,246117,1,1,1,0,2023-02-11,2023-03-21,1,38
35886.0,437047,1,0,1,1,2023-01-06,2023-01-12,0,6
35886.0,437047,1,0,1,1,2023-01-06,2023-02-11,0,36
35886.0,437047,1,0,1,0,2023-01-12,2023-02-11,1,30
35886.0,504010,2,2,2,0,2023-01-06,2023-01-12,2,6
35886.0,504010,2,0,2,0,2023-01-06,2023-01-12,2,6
35886.0,505018,3,3,2,0,2023-01-06,2023-01-12,2,6
35886.0,571019,1,0,1,0,2023-01-06,2023-01-12,1,6
35886.0,829012,4,0,4,0,2023-01-06,2023-01-12,4,6
35886.0,1AB1973,1,1,1,0,2023-01-06,2023-01-20,1,14
35886.0,1AB1973,1,0,1,0,2023-01-06,2023-01-12,1,6
35886.0,1AB1973,1,1,1,0,2023-01-12,2023-01-20,1,8
35980.0,225012,1,1,1,1,2022-12-27,2023-01-30,0,34
35980.0,233023,1,1,1,1,2022-12-27,2023-01-30,0,34
35980.0,309170,1,1,1,1,2022-12-27,2023-01-30,0,34
35980.0,373019,1,1,1,1,2022-12-27,2023-01-30,0,34
35980.0,374025,1,1,1,1,2022-12-27,2023-01-30,0,34
35980.0,387010,1,1,1,1,2022-12-27,2023-01-30,0,34
35980.0,387028,1,1,1,1,2022-12-27,2023-01-30,0,34
35980.0,387036,1,1,1,1,2022-12-27,2023-01-30,0,34
35980.0,388018,1,1,1,1,2022-12-27,2023-01-30,0,34
35980.0,1676404,6,6,4,4,2023-01-27,2023-01-31,0,4
35980.0,2305135,4,4,4,4,2022-12-27,2023-01-30,0,34
35980.0,5307401,10,0,5,0,2022-12-27,2023-01-03,5,7
35980.0,5307401,6,0,5,0,2022-12-27,2023-01-30,5,34
35980.0,5307401,4,0,5,0,2022-12-27,2023-01-27,5,31
35980.0,5307401,6,0,5,0,2022-12-27,2023-01-31,5,35
35980.0,5307401,6,0,10,0,2023-01-03,2023-01-30,10,27
35980.0,5307401,4,0,10,0,2023-01-03,2023-01-27,10,24
35980.0,5307401,6,0,10,0,2023-01-03,2023-01-31,10,28
35980.0,5307401,6,0,6,0,2023-01-30,2023-01-31,6,1
35980.0,5307401,6,0,4,0,2023-01-27,2023-01-30,4,3
35980.0,5307401,6,0,4,0,2023-01-27,2023-01-31,4,4
35980.0,6598405,6,6,5,5,2022-12-27,2023-01-30,0,34
35980.0,6623400,6,6,5,5,2022-12-27,2023-01-30,0,34
35980.0,6968020,1,1,1,1,2022-12-27,2023-01-30,0,34
35980.0,6968038,1,1,1,1,2022-12-27,2023-01-30,0,34
35980.0,1AA0003,1,1,1,1,2022-12-27,2023-01-30,0,34
35980.0,1AA0004,1,1,1,1,2022-12-27,2023-01-30,0,34
36030.0,97403,6,6,4,4,2023-01-18,2023-03-08,0,49
36098.0,4608404,2,2,2,2,2023-01-31,2023-03-28,0,56
36098.0,5482401,4,4,2,2,2023-01-31,2023-03-28,0,56
36296.0,367012,2,2,2,2,2023-01-25,2023-03-02,0,36
36296.0,504010,4,0,2,2,2023-01-25,2023-03-02,0,36
36296.0,5482401,8,8,8,8,2023-01-25,2023-03-02,0,36
36296.0,1AB2919,4,4,4,4,2023-01-25,2023-03-02,0,36
36412.0,5406,4,4,4,0,2023-02-05,2023-03-02,4,25
36521.0,14407,3,3,8,0,2023-02-07,2023-03-13,8,34
36521.0,14407,4,4,8,0,2023-02-07,2023-03-06,8,27
36521.0,14407,5,5,8,0,2023-02-07,2023-03-21,8,42
36521.0,14407,4,4,8,0,2023-02-07,2023-02-15,8,8
36521.0,14407,5,5,3,3,2023-03-13,2023-03-21,0,8
36521.0,14407,5,5,4,4,2023-03-06,2023-03-21,0,15
36521.0,14407,4,4,4,4,2023-02-15,2023-03-06,0,19
36521.0,14407,5,5,4,4,2023-02-15,2023-03-21,0,34
36521.0,97403,4,4,4,4,2023-02-07,2023-03-06,0,27
36521.0,97403,4,4,4,4,2023-02-07,2023-02-15,0,8
36521.0,97403,4,4,4,4,2023-02-15,2023-03-06,0,19
36521.0,365016,1,1,1,1,2023-02-15,2023-03-06,0,19
36521.0,504010,2,2,1,0,2023-02-07,2023-03-06,1,27
36521.0,504010,2,2,1,0,2023-02-07,2023-02-15,1,8
36521.0,504010,2,2,2,2,2023-02-15,2023-03-06,0,19
36521.0,505018,3,0,4,0,2023-02-07,2023-03-13,4,34
36521.0,505018,3,0,4,0,2023-02-07,2023-03-06,4,27
36521.0,505018,3,3,4,0,2023-02-07,2023-02-15,4,8
36521.0,505018,3,3,4,0,2023-02-07,2023-03-21,4,42
36521.0,505018,3,3,3,0,2023-03-13,2023-03-21,3,8
36521.0,505018,3,0,3,0,2023-03-06,2023-03-13,3,7
36521.0,505018,3,3,3,0,2023-03-06,2023-03-21,3,15
36521.0,505018,3,0,3,3,2023-02-15,2023-03-13,0,26
36521.0,505018,3,0,3,3,2023-02-15,2023-03-06,0,19
36521.0,505018,3,3,3,3,2023-02-15,2023-03-21,0,34
36521.0,5482401,6,6,4,4,2023-03-06,2023-03-13,0,7
36521.0,5482401,6,6,4,4,2023-02-15,2023-03-13,0,26
36521.0,5482401,4,4,4,4,2023-02-15,2023-03-06,0,19
36521.0,1AB2733,1,1,1,1,2023-02-15,2023-03-06,0,19
36521.0,1AB2735,1,1,1,1,2023-02-15,2023-03-06,0,19
36521.0,1AB2919,12,12,12,12,2023-02-15,2023-03-06,0,19
36614.0,89400,2,2,2,0,2023-02-20,2023-02-23,2,3
36614.0,372011,1,1,1,0,2023-02-20,2023-03-21,1,29
36614.0,373019,1,1,1,0,2023-02-20,2023-03-21,1,29
36614.0,829012,1,1,2,0,2023-02-20,2023-03-21,2,29
36619.0,91488,6,6,4,4,2023-01-06,2023-01-24,0,18
36619.0,91488,4,4,4,4,2023-01-06,2023-03-06,0,59
36619.0,378019,2,2,1,1,2023-01-06,2023-01-24,0,18
36619.0,387028,2,2,2,0,2023-02-09,2023-03-03,2,22
36619.0,4520400,4,4,4,0,2023-02-09,2023-03-03,4,22
36619.0,4520400,4,4,4,0,2023-02-09,2023-03-06,4,25
36619.0,4520400,4,4,4,4,2023-03-03,2023-03-06,0,3
36619.0,4907400,14,0,6,6,2023-01-24,2023-02-09,0,16
36619.0,4907400,14,14,6,6,2023-01-24,2023-03-03,0,38
36619.0,4907400,22,22,6,6,2023-01-24,2023-03-06,0,41
36619.0,4907400,6,6,4,4,2023-01-06,2023-01-24,0,18
36619.0,4907400,14,0,4,4,2023-01-06,2023-02-09,0,34
36619.0,4907400,14,14,4,4,2023-01-06,2023-03-03,0,56
36619.0,4907400,22,22,4,4,2023-01-06,2023-03-06,0,59
36619.0,4907400,14,14,14,0,2023-02-09,2023-03-03,14,22
36619.0,4907400,22,22,14,0,2023-02-09,2023-03-06,14,25
36619.0,4907400,22,22,14,14,2023-03-03,2023-03-06,0,3
36619.0,5482401,16,16,15,15,2023-01-24,2023-03-06,0,41
36619.0,5482401,15,15,15,15,2023-01-06,2023-01-24,0,18
36619.0,5482401,16,16,15,15,2023-01-06,2023-03-06,0,59
36619.0,6598405,16,0,16,16,2023-01-24,2023-03-03,0,38
36619.0,6598405,16,16,16,16,2023-01-24,2023-02-09,0,16
36619.0,6598405,24,24,16,16,2023-01-24,2023-03-06,0,41
36619.0,6598405,16,16,15,15,2023-01-06,2023-01-24,0,18
36619.0,6598405,16,0,15,15,2023-01-06,2023-03-03,0,56
36619.0,6598405,16,16,15,15,2023-01-06,2023-02-09,0,34
36619.0,6598405,24,24,15,15,2023-01-06,2023-03-06,0,59
36619.0,6598405,24,24,16,0,2023-03-03,2023-03-06,16,3
36619.0,6598405,16,0,16,16,2023-02-09,2023-03-03,0,22
36619.0,6598405,24,24,16,16,2023-02-09,2023-03-06,0,25
36619.0,6623400,12,12,10,10,2023-01-24,2023-03-03,0,38
36619.0,6623400,12,0,10,10,2023-01-24,2023-02-09,0,16
36619.0,6623400,14,14,10,10,2023-01-24,2023-03-06,0,41
36619.0,6623400,14,14,12,12,2023-03-03,2023-03-06,0,3
36619.0,6623400,12,12,12,0,2023-02-09,2023-03-03,12,22
36619.0,6623400,14,14,12,0,2023-02-09,2023-03-06,12,25
36638.0,829012,3,0,2,0,2022-12-21,2023-02-06,2,47
36638.0,1AB2733,1,1,3,0,2022-12-21,2023-02-06,3,47
36697.0,6444095,1,1,1,1,2023-01-31,2023-02-03,0,3
36701.0,6625331,6,6,2,2,2023-03-13,2023-03-14,0,1
36728.0,369018,1,1,1,0,2023-03-13,2023-03-15,1,2
36728.0,373019,1,1,1,0,2023-03-13,2023-03-15,1,2
36728.0,374025,1,1,1,0,2023-03-13,2023-03-15,1,2
36728.0,1AA0003,1,1,1,0,2023-03-13,2023-03-15,1,2
36730.0,504010,8,0,5,5,2023-01-19,2023-03-09,0,49
36730.0,505018,12,12,8,8,2023-01-19,2023-03-09,0,49
36752.0,8740012,2,2,2,2,2022-12-13,2023-02-06,0,55
36768.0,504010,3,3,2,2,2023-01-23,2023-02-15,0,23
36768.0,505018,5,5,5,5,2023-01-23,2023-02-15,0,23
36848.0,367012,1,1,1,1,2023-01-11,2023-03-09,0,57
36848.0,378019,1,1,1,1,2023-01-11,2023-03-09,0,57
37094.0,504010,1,1,1,1,2023-01-11,2023-03-01,0,49
37225.0,829012,2,2,2,2,2023-01-05,2023-01-09,0,4
37306.0,8740012,4,4,2,2,2022-12-15,2023-01-11,0,27
37382.0,505018,13,13,12,0,2023-02-13,2023-03-09,12,24
37382.0,571019,4,4,4,0,2023-02-13,2023-03-09,4,24
37382.0,5482401,4,4,4,4,2023-02-13,2023-03-09,0,24
37529.0,387036,8,8,2,2,2022-11-28,2023-01-06,0,39
37721.0,45626,2,2,2,0,2023-02-28,2023-03-14,2,14
37721.0,504010,2,2,2,2,2023-01-27,2023-03-07,0,39
37721.0,505018,4,4,4,4,2023-01-27,2023-03-07,0,39
37721.0,9076051,1,1,1,0,2023-02-13,2023-03-13,1,28
37723.0,8720790,1,1,1,1,2023-01-18,2023-03-11,0,52
37756.0,5406,6,6,2,0,2022-12-12,2023-01-20,2,39
37756.0,24406,3,3,3,0,2022-12-12,2023-01-20,3,39
37756.0,309170,2,2,2,0,2022-12-12,2023-01-20,2,39
37960.0,505018,5,5,3,3,2023-01-30,2023-03-05,0,34
37964.0,358011,2,2,1,1,2023-01-03,2023-01-17,0,14
37992.0,829012,2,2,2,2,2023-02-23,2023-03-08,0,13
38152.0,97403,10,10,6,6,2023-01-24,2023-02-21,0,28
38152.0,504010,1,1,1,0,2023-02-21,2023-02-28,1,7
38152.0,727752,1,0,1,0,2023-02-21,2023-02-28,1,7
38152.0,6979407,2,2,2,0,2023-02-21,2023-02-28,2,7
38211.0,24406,2,2,2,2,2023-01-20,2023-03-09,0,48
38211.0,62349,3,3,1,1,2023-01-20,2023-03-09,0,48
38211.0,5482401,8,8,4,4,2023-01-20,2023-03-09,0,48
38211.0,8720790,8,8,2,2,2023-01-20,2023-03-09,0,48
38216.0,62349,1,1,1,1,2022-12-30,2023-02-17,0,49
38252.0,504010,1,1,1,1,2023-01-08,2023-01-09,0,1
38296.0,58405,2,2,2,2,2023-01-26,2023-02-06,0,11
38300.0,504010,5,5,2,2,2023-01-31,2023-02-10,0,10
38301.0,504010,4,4,3,3,2023-01-03,2023-01-30,0,27
38301.0,504010,6,6,3,3,2023-01-03,2023-02-10,0,38
38301.0,504010,6,6,4,4,2023-01-30,2023-02-10,0,11
38301.0,504010,6,6,2,2,2023-02-06,2023-02-10,0,4
38301.0,505018,8,8,6,6,2023-01-03,2023-01-30,0,27
38301.0,505018,16,0,6,6,2023-01-03,2023-02-06,0,34
38301.0,505018,16,16,6,6,2023-01-03,2023-02-10,0,38
38301.0,505018,16,0,8,8,2023-01-30,2023-02-06,0,7
38301.0,505018,16,16,8,8,2023-01-30,2023-02-10,0,11
38301.0,505018,16,16,16,0,2023-02-06,2023-02-10,16,4
38301.0,2101012,1,1,1,1,2023-02-21,2023-02-27,0,6
38301.0,2101012,1,1,1,1,2023-02-02,2023-02-27,0,25
38301.0,2101012,1,1,1,1,2023-02-02,2023-02-21,0,19
38301.0,2101020,1,0,1,1,2023-02-21,2023-02-27,0,6
38301.0,2101020,1,0,1,1,2023-02-02,2023-02-27,0,25
38301.0,2101020,1,1,1,1,2023-02-02,2023-02-21,0,19
38301.0,2101046,1,0,1,0,2023-02-21,2023-02-27,1,6
38301.0,2101046,1,0,1,1,2023-02-02,2023-02-27,0,25
38301.0,2101046,1,0,1,1,2023-02-02,2023-02-21,0,19
38301.0,2101053,1,1,1,1,2023-02-21,2023-02-27,0,6
38301.0,2101053,1,1,1,1,2023-02-02,2023-02-27,0,25
38301.0,2101053,1,1,1,1,2023-02-02,2023-02-21,0,19
38478.0,97403,12,12,12,12,2022-12-13,2023-02-06,0,55
38489.0,5406,2,2,1,1,2023-01-25,2023-03-09,0,43
38549.0,14407,4,4,3,3,2022-11-28,2023-01-23,0,56
38608.0,504010,2,2,2,0,2023-03-08,2023-03-20,2,12
38608.0,504010,2,0,1,0,2023-01-24,2023-03-08,1,43
38608.0,504010,2,2,1,0,2023-01-24,2023-03-20,1,55
38608.0,505018,4,4,2,2,2023-01-24,2023-03-08,0,43
38609.0,505018,6,6,6,0,2023-01-09,2023-01-30,6,21
38720.0,34405,2,2,2,2,2022-11-09,2022-12-13,0,34
38720.0,4520400,2,2,2,0,2022-11-09,2022-12-13,2,34
38726.0,62349,1,1,1,0,2023-01-25,2023-02-21,1,27
38726.0,62349,1,0,1,0,2023-01-24,2023-01-25,1,1
38726.0,62349,1,1,1,0,2023-01-24,2023-02-21,1,28
38726.0,62349,1,0,1,1,2023-01-24,2023-01-25,0,1
38726.0,62349,1,1,1,1,2023-01-24,2023-02-21,0,28
38726.0,91488,8,0,8,8,2022-12-23,2023-01-25,0,33
38726.0,91488,8,0,8,8,2022-12-23,2023-01-24,0,32
38726.0,91488,8,8,8,8,2022-12-23,2023-01-24,0,32
38726.0,91488,8,8,8,8,2022-12-23,2023-02-21,0,60
38726.0,91488,6,6,5,0,2023-01-25,2023-02-21,5,27
38726.0,91488,8,8,5,0,2023-01-25,2023-02-21,5,27
38726.0,91488,6,6,8,0,2023-01-25,2023-02-21,8,27
38726.0,91488,8,8,8,0,2023-01-25,2023-02-21,8,27
38726.0,91488,5,0,5,0,2023-01-24,2023-01-25,5,1
38726.0,91488,8,0,5,0,2023-01-24,2023-01-25,5,1
38726.0,91488,6,6,5,0,2023-01-24,2023-02-21,5,28
38726.0,91488,8,8,5,0,2023-01-24,2023-02-21,5,28
38726.0,91488,5,0,5,5,2023-01-24,2023-01-25,0,1
38726.0,91488,8,0,5,5,2023-01-24,2023-01-25,0,1
38726.0,91488,6,6,5,5,2023-01-24,2023-02-21,0,28
38726.0,91488,8,8,5,5,2023-01-24,2023-02-21,0,28
38726.0,91488,5,0,8,0,2023-01-24,2023-01-25,8,1
38726.0,91488,8,0,8,0,2023-01-24,2023-01-25,8,1
38726.0,91488,6,6,8,0,2023-01-24,2023-02-21,8,28
38726.0,91488,8,8,8,0,2023-01-24,2023-02-21,8,28
38726.0,91488,8,0,8,8,2023-01-24,2023-01-25,0,1
38726.0,91488,8,8,8,8,2023-01-24,2023-02-21,0,28
38726.0,97403,1,1,2,0,2023-01-24,2023-03-22,2,57
38726.0,97403,2,2,2,0,2023-01-24,2023-01-25,2,1
38726.0,97403,1,1,2,0,2023-01-24,2023-02-21,2,28
38726.0,97403,1,1,1,1,2023-02-21,2023-03-22,0,29
38726.0,225012,1,1,1,0,2023-01-24,2023-01-25,1,1
38726.0,367012,1,1,1,0,2023-01-24,2023-01-25,1,1
38726.0,4520400,2,2,2,0,2023-01-24,2023-01-25,2,1
38726.0,4907400,4,4,3,0,2022-12-23,2023-02-21,3,60
38726.0,5482401,6,6,6,6,2022-12-23,2023-01-24,0,32
38726.0,5482401,8,0,6,6,2022-12-23,2023-01-24,0,32
38726.0,5482401,10,10,6,6,2022-12-23,2023-02-21,0,60
38726.0,5482401,10,10,2,2,2023-01-25,2023-02-21,0,27
38726.0,5482401,10,10,6,6,2023-01-24,2023-02-21,0,28
38726.0,5482401,2,2,8,0,2023-01-24,2023-01-25,8,1
38726.0,5482401,10,10,8,0,2023-01-24,2023-02-21,8,28
38726.0,6179403,3,3,1,1,2022-12-23,2023-01-25,0,33
38726.0,6179403,3,0,1,1,2022-12-23,2023-01-24,0,32
38726.0,6179403,3,3,1,1,2022-12-23,2023-02-21,0,60
38726.0,6179403,3,3,3,3,2023-01-25,2023-02-21,0,27
38726.0,6179403,3,3,3,0,2023-01-24,2023-01-25,3,1
38726.0,6179403,2,2,3,0,2023-01-24,2023-03-22,3,57
38726.0,6179403,3,3,3,0,2023-01-24,2023-02-21,3,28
38726.0,6598405,4,0,4,4,2022-12-23,2023-01-25,0,33
38726.0,6598405,4,0,4,4,2022-12-23,2023-01-24,0,32
38726.0,6598405,4,4,4,4,2022-12-23,2023-01-24,0,32
38726.0,6598405,5,5,4,4,2022-12-23,2023-02-21,0,60
38726.0,6598405,2,2,4,0,2023-01-25,2023-03-22,4,56
38726.0,6598405,5,5,4,0,2023-01-25,2023-02-21,4,27
38726.0,6598405,4,0,4,0,2023-01-24,2023-01-25,4,1
38726.0,6598405,2,2,4,0,2023-01-24,2023-03-22,4,57
38726.0,6598405,5,5,4,0,2023-01-24,2023-02-21,4,28
38726.0,6598405,4,0,4,4,2023-01-24,2023-01-25,0,1
38726.0,6598405,5,5,4,4,2023-01-24,2023-02-21,0,28
38726.0,1AB2693,1,0,1,0,2023-01-24,2023-01-25,1,1
38726.0,1AB2693,1,0,1,1,2023-01-24,2023-01-25,0,1
38801.0,504010,9,9,4,4,2023-01-09,2023-01-31,0,22
38801.0,505018,14,14,3,3,2023-01-09,2023-01-31,0,22
38801.0,4757409,10,0,4,4,2023-01-09,2023-01-31,0,22
38806.0,97403,4,4,2,0,2023-02-27,2023-03-20,2,21
38806.0,4520400,4,4,2,2,2023-02-27,2023-03-20,0,21
38806.0,6179403,3,3,3,3,2023-02-14,2023-03-20,0,34
38844.0,315094,2,2,1,1,2022-11-28,2023-01-06,0,39
38844.0,387036,1,1,1,0,2023-03-07,2023-03-10,1,3
38844.0,504010,3,3,1,1,2023-01-06,2023-02-01,0,26
38844.0,504010,4,4,1,1,2023-01-06,2023-02-06,0,31
38844.0,504010,4,4,3,3,2023-02-01,2023-02-06,0,5
38844.0,505018,9,9,3,3,2023-01-06,2023-02-06,0,31
38844.0,6598405,16,16,6,6,2022-11-28,2023-01-06,0,39
38846.0,45626,4,4,4,0,2023-02-27,2023-03-07,4,8
38846.0,504010,6,6,4,4,2023-01-03,2023-03-02,0,58
38846.0,505018,12,12,12,12,2023-01-03,2023-03-02,0,58
38846.0,5482401,6,6,4,4,2023-01-30,2023-03-02,0,31
38873.0,504010,4,4,4,4,2023-01-12,2023-03-06,0,53
38873.0,505018,8,8,8,8,2023-01-12,2023-03-06,0,53
38901.0,5985405,2,2,1,0,2023-02-06,2023-02-27,1,21
38939.0,98401,4,4,2,2,2023-01-18,2023-02-06,0,19
38939.0,1105403,14,0,8,8,2023-01-18,2023-02-06,0,19
38939.0,4757409,11,11,1,0,2023-02-06,2023-02-14,1,8
38984.0,91488,2,2,2,0,2022-12-23,2023-01-06,2,14
38984.0,365016,4,4,1,1,2022-12-23,2023-01-06,0,14
38984.0,6598405,10,10,10,0,2022-12-23,2023-01-06,10,14
38984.0,1AA0003,4,4,1,1,2022-12-23,2023-01-06,0,14
39001.0,5406,2,2,2,0,2023-02-06,2023-02-16,2,10
39001.0,97403,1,1,1,0,2023-02-06,2023-02-16,1,10
39001.0,1402403,4,4,4,0,2023-02-06,2023-02-16,4,10
39001.0,1AB2190,1,1,1,0,2023-02-06,2023-02-16,1,10
39022.0,721010,2,2,2,0,2023-03-03,2023-03-06,2,3
39022.0,723016,3,3,3,0,2023-03-03,2023-03-06,3,3
39036.0,829012,5,5,3,3,2023-01-23,2023-03-08,0,44
39047.0,504010,2,2,2,2,2023-01-23,2023-03-02,0,38
39097.0,829012,3,0,1,1,2023-02-17,2023-02-20,0,3
39097.0,829012,3,3,1,1,2023-02-17,2023-02-20,0,3
39131.0,504010,3,3,3,3,2023-01-08,2023-02-09,0,32
39131.0,505018,7,7,4,4,2023-01-08,2023-02-09,0,32
39131.0,634056,3,3,3,0,2023-01-08,2023-02-28,3,51
39131.0,799215,1,0,1,0,2023-01-08,2023-02-28,1,51
39172.0,91488,10,10,8,8,2022-12-27,2023-01-23,0,27
39172.0,91488,10,10,8,8,2022-12-27,2023-02-21,0,56
39172.0,91488,10,10,10,10,2023-01-23,2023-02-21,0,29
39172.0,367012,2,2,1,1,2022-12-27,2023-01-23,0,27
39172.0,5482401,14,14,14,14,2022-12-27,2023-01-23,0,27
39172.0,6598405,6,6,6,6,2023-01-23,2023-02-21,0,29
39187.0,8720774,1,1,1,0,2022-12-06,2023-01-24,1,49
39191.0,367012,2,2,2,0,2023-01-09,2023-02-02,2,24
39208.0,24406,4,0,4,4,2023-01-30,2023-02-03,0,4
39208.0,24406,4,0,4,4,2023-01-30,2023-02-03,0,4
39208.0,91488,4,0,4,4,2023-01-30,2023-02-03,0,4
39208.0,97403,6,0,4,4,2023-01-30,2023-02-03,0,4
39208.0,3029395,4,0,1,1,2023-01-30,2023-02-03,0,4
39208.0,4520400,3,0,3,3,2023-01-30,2023-02-03,0,4
39208.0,5482401,8,0,3,3,2023-01-30,2023-02-03,0,4
39208.0,6598405,6,0,6,6,2023-01-30,2023-02-03,0,4
39208.0,8720790,4,0,1,1,2023-01-30,2023-02-03,0,4
39208.0,1AB3449,1,0,1,1,2023-01-30,2023-02-03,0,4
39208.0,1AB3449,1,0,1,1,2023-01-30,2023-02-03,0,4
39231.0,5482401,5,5,4,4,2022-12-08,2023-02-06,0,60
39231.0,6598405,6,6,1,1,2022-12-08,2023-02-06,0,60
39231.0,6623400,6,6,1,1,2022-12-08,2023-02-06,0,60
39231.0,1AB3456,3,3,4,0,2022-12-08,2023-02-01,4,55
39231.0,1AB3456,3,3,6,0,2022-12-08,2023-02-01,6,55
39231.0,1AB3457,2,2,2,0,2022-12-08,2023-02-01,2,55
39231.0,1AB4571,5,5,3,3,2022-12-08,2023-01-02,0,25
39231.0,1AB4571,5,5,3,3,2022-12-08,2023-02-01,0,55
39231.0,1AB4571,5,5,5,5,2023-01-02,2023-02-01,0,30
39231.0,1AB4964,3,0,4,0,2022-12-08,2023-02-01,4,55
39231.0,1AB4964,3,0,4,0,2022-12-08,2023-02-01,4,55
39249.0,546012,1,1,1,0,2023-01-29,2023-02-01,1,3
39249.0,548026,2,2,1,0,2023-01-29,2023-02-01,1,3
39249.0,549024,2,2,1,0,2023-01-29,2023-02-01,1,3
39256.0,5406,12,0,12,0,2023-02-14,2023-02-28,12,14
39256.0,5406,12,0,12,0,2023-02-14,2023-02-28,12,14
39256.0,91488,2,2,2,2,2023-01-10,2023-02-14,0,35
39256.0,5482401,8,8,2,2,2023-01-10,2023-02-14,0,35
39256.0,8720790,13,13,1,1,2023-01-10,2023-02-14,0,35
39256.0,8720790,13,13,2,2,2023-01-10,2023-02-14,0,35
39321.0,829012,6,6,3,3,2023-03-17,2023-03-21,0,4
39366.0,829012,2,2,2,0,2022-12-23,2023-02-07,2,46
39380.0,539017,10,10,5,5,2023-02-20,2023-03-06,0,14
39398.0,523010,1,0,1,0,2022-12-30,2023-01-12,1,13
39398.0,571019,2,2,1,0,2022-12-30,2023-01-03,1,4
39398.0,571050,2,2,2,0,2022-12-30,2023-01-03,2,4
39398.0,630054,13,13,12,0,2022-12-30,2023-01-12,12,13
39398.0,630062,10,0,10,0,2022-12-30,2023-01-12,10,13
39398.0,919011,2,2,2,0,2022-12-30,2023-01-12,2,13
39413.0,24406,2,2,2,2,2023-01-11,2023-02-28,0,48
39413.0,97403,2,2,2,2,2023-01-11,2023-02-28,0,48
39413.0,504010,11,11,5,5,2023-02-15,2023-02-24,0,9
39413.0,505018,17,17,9,9,2023-02-15,2023-02-24,0,9
39413.0,6598405,2,2,2,2,2023-01-11,2023-02-28,0,48
39413.0,9511404,1,1,1,1,2023-01-11,2023-02-28,0,48
39503.0,5406,8,8,8,0,2023-01-16,2023-02-07,8,22
39552.0,89400,8,8,8,8,2023-02-07,2023-03-14,0,35
39612.0,658031,1,1,1,0,2023-02-20,2023-03-26,1,34
39659.0,367012,2,2,1,1,2023-01-09,2023-02-03,0,25
39659.0,387028,1,1,1,1,2023-01-09,2023-02-03,0,25
39659.0,387028,1,1,1,1,2023-01-09,2023-02-03,0,25
39659.0,387036,2,2,2,2,2023-01-09,2023-02-03,0,25
39659.0,1AB2733,1,1,1,1,2023-01-09,2023-02-03,0,25
39659.0,1AB2735,1,1,1,1,2023-01-09,2023-02-03,0,25
39659.0,1AB2919,8,8,4,4,2023-01-09,2023-02-03,0,25
39663.0,14407,20,20,10,10,2023-01-03,2023-02-27,0,55
39663.0,97403,5,5,5,5,2023-01-03,2023-02-27,0,55
39663.0,5482401,3,3,3,3,2023-01-03,2023-02-27,0,55
39679.0,8740012,4,4,4,0,2022-12-30,2023-01-24,4,25
39714.0,1628,2,2,2,0,2023-02-03,2023-02-13,2,10
39714.0,5406,10,10,10,0,2023-02-03,2023-02-13,10,10
39714.0,396029,2,2,2,0,2023-02-03,2023-02-13,2,10
39714.0,437047,1,1,1,0,2023-02-03,2023-02-13,1,10
39714.0,1AA0004,9,9,9,0,2023-02-03,2023-02-13,9,10
39726.0,394106,1,1,1,0,2023-02-07,2023-03-09,1,30
39726.0,505018,1,0,1,1,2023-02-07,2023-03-09,0,30
39735.0,505018,15,15,15,0,2023-01-28,2023-02-13,15,16
39751.0,5482401,4,4,2,2,2022-12-21,2023-01-19,0,29
39867.0,505018,10,10,2,2,2023-01-12,2023-02-24,0,43
39967.0,8666408,20,20,5,0,2023-01-26,2023-01-27,5,1
39967.0,8666408,1,1,5,0,2023-01-26,2023-01-27,5,1
39967.0,8666408,3,3,5,0,2023-01-26,2023-01-27,5,1
40114.0,6623400,4,4,2,2,2023-02-01,2023-02-16,0,15
40198.0,504010,6,6,6,0,2023-01-11,2023-03-08,6,56
40198.0,505018,17,17,15,0,2023-01-11,2023-03-08,15,56
40198.0,542010,2,2,2,0,2023-01-11,2023-03-08,2,56
40198.0,543018,2,2,2,0,2023-01-11,2023-03-08,2,56
40246.0,504010,4,4,4,4,2023-01-11,2023-03-06,0,54
40246.0,505018,9,9,9,9,2023-01-11,2023-03-06,0,54
40322.0,373019,1,1,1,0,2023-01-18,2023-02-15,1,28
40322.0,387036,1,1,1,0,2023-01-18,2023-02-15,1,28
40322.0,829012,2,2,1,0,2022-12-29,2023-01-18,1,20
40322.0,829012,2,2,2,0,2022-12-29,2023-01-18,2,20
40322.0,829012,2,2,2,0,2022-12-29,2023-01-18,2,20
40322.0,3100203,1,0,1,0,2023-01-18,2023-02-15,1,28
40322.0,8720790,2,2,2,0,2023-01-18,2023-02-15,2,28
40334.0,160109,1,0,1,1,2023-02-23,2023-03-02,0,7
40334.0,160109,1,1,1,1,2023-02-23,2023-03-02,0,7
40334.0,160135,1,0,1,1,2023-02-23,2023-03-02,0,7
40334.0,160135,1,1,1,1,2023-02-23,2023-03-02,0,7
40375.0,97403,4,4,2,2,2023-03-06,2023-03-14,0,8
40414.0,367012,2,2,2,2,2023-01-10,2023-02-15,0,36
40414.0,5482401,8,8,4,4,2023-01-10,2023-02-15,0,36
40414.0,6598405,3,3,1,1,2023-01-10,2023-02-15,0,36
40414.0,6623400,4,4,2,2,2023-01-10,2023-02-15,0,36
40414.0,1AB2733,1,0,1,1,2023-01-10,2023-02-15,0,36
40414.0,1AB2919,6,6,5,5,2023-01-10,2023-02-15,0,36
40436.0,97403,3,3,3,0,2022-12-27,2023-01-09,3,13
40436.0,97403,2,2,3,0,2022-12-27,2023-01-30,3,34
40436.0,97403,3,3,3,3,2023-01-09,2023-03-01,0,51
40436.0,97403,3,3,2,2,2023-01-30,2023-03-01,0,30
40436.0,367012,2,2,1,1,2023-01-30,2023-03-01,0,30
40436.0,4907400,1,1,1,0,2022-12-27,2023-01-09,1,13
40436.0,4907400,1,1,1,0,2022-12-27,2023-01-30,1,34
40436.0,4907400,1,1,1,1,2023-01-09,2023-01-30,0,21
40436.0,5482401,3,3,1,1,2023-01-30,2023-03-01,0,30
40436.0,6598405,2,2,2,2,2022-12-27,2023-01-30,0,34
40436.0,6598405,2,2,2,2,2023-01-30,2023-03-01,0,30
40436.0,1AB2919,8,8,2,2,2022-12-27,2023-01-30,0,34
40436.0,1AB2919,8,0,8,8,2023-01-30,2023-03-01,0,30
40437.0,634064,4,4,1,1,2022-12-20,2023-01-16,0,27
40437.0,5482401,4,4,4,4,2023-01-10,2023-02-20,0,41
40438.0,97403,4,4,2,2,2023-01-05,2023-01-24,0,19
40438.0,97403,3,3,2,2,2023-01-05,2023-03-02,0,56
40438.0,634049,6,6,3,3,2023-01-24,2023-03-02,0,37
40438.0,8720790,1,1,1,1,2023-01-05,2023-01-24,0,19
40441.0,48406,2,2,2,2,2023-02-07,2023-03-15,0,36
40441.0,48406,2,2,2,2,2023-01-02,2023-02-07,0,36
40441.0,97403,4,4,2,2,2023-02-07,2023-03-15,0,36
40441.0,4907400,2,2,2,2,2023-02-07,2023-03-15,0,36
40441.0,5482401,4,4,4,4,2023-02-07,2023-03-15,0,36
40441.0,5482401,4,4,2,2,2023-01-02,2023-02-07,0,36
40441.0,1AB2919,4,4,4,4,2023-01-02,2023-02-07,0,36
40451.0,504010,6,6,4,4,2023-01-04,2023-01-06,0,2
40451.0,504010,5,5,4,4,2023-01-04,2023-01-10,0,6
40464.0,8720790,2,2,2,2,2022-12-23,2023-02-16,0,55
40464.0,1AB2733,1,1,1,0,2023-02-16,2023-02-20,1,4
40521.0,504010,3,3,2,2,2022-12-27,2023-02-17,0,52
40521.0,504010,3,3,1,1,2023-02-01,2023-02-17,0,16
40521.0,504010,1,1,1,1,2023-01-09,2023-02-01,0,23
40521.0,504010,3,3,1,1,2023-01-09,2023-02-17,0,39
40521.0,505018,4,0,2,2,2022-12-27,2023-02-01,0,36
40521.0,505018,4,4,2,2,2022-12-27,2023-01-09,0,13
40521.0,505018,7,7,2,2,2022-12-27,2023-02-17,0,52
40521.0,505018,7,7,4,0,2023-02-01,2023-02-17,4,16
40521.0,505018,4,0,4,4,2023-01-09,2023-02-01,0,23
40521.0,505018,7,7,4,4,2023-01-09,2023-02-17,0,39
40625.0,14407,5,5,4,0,2023-01-18,2023-03-08,4,49
40625.0,24406,4,4,4,0,2023-01-18,2023-03-08,4,49
40625.0,5482401,8,8,8,0,2023-01-18,2023-03-08,8,49
40625.0,8720790,5,5,4,0,2023-01-18,2023-03-08,4,49
40628.0,91488,4,4,4,4,2023-01-24,2023-03-13,0,48
40628.0,97403,10,10,8,8,2023-01-24,2023-03-13,0,48
40628.0,504010,2,2,2,2,2023-01-24,2023-03-13,0,48
40628.0,505018,4,4,4,4,2023-01-24,2023-03-13,0,48
40644.0,8717714,4,4,2,2,2023-01-16,2023-01-18,0,2
40697.0,91488,12,12,10,10,2022-12-24,2023-02-15,0,53
40697.0,91488,12,12,8,8,2023-01-20,2023-02-15,0,26
40697.0,91488,11,11,8,8,2023-01-20,2023-03-20,0,59
40697.0,1676404,8,8,8,8,2022-12-12,2023-01-27,0,46
40697.0,1676404,10,0,8,8,2023-01-27,2023-03-20,0,52
40697.0,1676404,10,10,8,8,2023-01-27,2023-03-20,0,52
40697.0,1677402,4,4,4,4,2023-01-18,2023-02-22,0,35
40697.0,5307401,6,0,8,0,2022-12-24,2023-01-18,8,25
40697.0,5307401,8,0,8,0,2022-12-24,2023-01-20,8,27
40697.0,5307401,8,0,8,0,2022-12-24,2023-02-15,8,53
40697.0,5307401,8,0,8,0,2022-12-24,2023-01-27,8,34
40697.0,5307401,8,0,4,4,2022-11-01,2022-12-24,0,53
40697.0,5307401,8,0,4,4,2022-11-01,2022-12-12,0,41
40697.0,5307401,8,0,8,0,2022-12-12,2022-12-24,8,12
40697.0,5307401,6,0,8,0,2022-12-12,2023-01-18,8,37
40697.0,5307401,8,0,8,0,2022-12-12,2023-01-20,8,39
40697.0,5307401,8,0,8,0,2022-12-12,2023-01-27,8,46
40697.0,5307401,8,0,6,0,2023-01-18,2023-01-20,6,2
40697.0,5307401,8,0,6,0,2023-01-18,2023-02-15,6,28
40697.0,5307401,8,0,6,0,2023-01-18,2023-01-27,6,9
40697.0,5307401,8,0,8,0,2023-01-20,2023-02-15,8,26
40697.0,5307401,8,0,8,0,2023-01-20,2023-01-27,8,7
40697.0,5307401,8,0,8,0,2023-01-27,2023-02-15,8,19
40697.0,5482401,8,8,8,8,2023-01-20,2023-02-15,0,26
40697.0,5482401,12,12,8,8,2023-01-20,2023-03-20,0,59
40697.0,5482401,12,12,8,8,2023-02-15,2023-03-20,0,33
40697.0,6598405,18,18,8,8,2022-12-24,2023-01-20,0,27
40697.0,6598405,20,20,8,8,2022-12-24,2023-02-15,0,53
40697.0,6598405,20,20,2,2,2023-01-23,2023-02-15,0,23
40697.0,6598405,12,12,2,2,2023-01-23,2023-03-20,0,56
40697.0,6598405,20,20,18,18,2023-01-20,2023-02-15,0,26
40697.0,6623400,8,8,8,8,2022-12-24,2023-01-20,0,27
40697.0,6623400,8,8,8,8,2022-12-24,2023-02-15,0,53
40697.0,6623400,8,8,8,8,2023-01-20,2023-02-15,0,26
40857.0,1410406,13,13,2,2,2022-12-21,2023-01-04,0,14
40857.0,5482401,4,4,2,2,2022-12-21,2023-02-01,0,42
40860.0,1AB2919,10,10,10,0,2022-12-20,2023-01-10,10,21
40879.0,1402403,10,10,9,9,2023-02-10,2023-02-13,0,3
40909.0,504010,1,1,1,1,2022-12-30,2023-02-20,0,52
40909.0,505018,5,5,4,4,2022-12-30,2023-02-20,0,52
40909.0,575011,1,1,1,1,2022-12-30,2023-02-20,0,52
40909.0,576019,1,1,1,1,2022-12-30,2023-02-20,0,52
40909.0,631078,4,4,1,1,2022-12-30,2023-02-20,0,52
40909.0,639023,1,0,7,0,2022-12-30,2023-01-08,7,9
40909.0,639023,1,1,7,0,2022-12-30,2023-02-20,7,52
40909.0,639023,1,1,1,0,2023-01-08,2023-02-20,1,43
40909.0,644022,1,0,1,0,2022-12-30,2023-01-08,1,9
40909.0,644022,1,1,1,0,2022-12-30,2023-02-20,1,52
40909.0,644022,1,1,1,0,2023-01-08,2023-02-20,1,43
40909.0,829012,1,0,1,0,2022-12-30,2023-01-08,1,9
40909.0,829012,1,1,1,0,2022-12-30,2023-02-20,1,52
40909.0,829012,1,1,1,0,2023-01-08,2023-02-20,1,43
40909.0,8720790,2,2,2,2,2022-12-30,2023-02-20,0,52
40909.0,9511404,6,6,6,0,2022-12-30,2023-01-08,6,9
40909.0,9511404,2,2,6,0,2022-12-30,2023-02-20,6,52
40917.0,504010,3,3,2,2,2023-01-03,2023-02-23,0,51
40917.0,505018,4,4,3,3,2023-01-03,2023-02-23,0,51
40917.0,9511404,2,2,2,2,2022-11-29,2022-12-12,0,13
40945.0,504010,2,2,1,1,2023-02-06,2023-03-09,0,31
40945.0,505018,4,4,2,2,2023-02-06,2023-03-09,0,31
40945.0,829012,1,1,1,1,2022-12-28,2023-02-06,0,40
41002.0,5482401,20,20,5,5,2023-01-25,2023-03-24,0,58
41069.0,505018,5,5,14,0,2023-01-13,2023-01-30,14,17
41069.0,505018,5,5,14,0,2023-01-13,2023-02-06,14,24
41069.0,505018,5,5,10,0,2023-01-13,2023-01-30,10,17
41069.0,505018,5,5,10,0,2023-01-13,2023-02-06,10,24
41069.0,505018,5,5,5,5,2023-01-30,2023-02-06,0,7
41069.0,5482401,8,8,4,0,2023-01-13,2023-03-02,4,48
41069.0,5482401,8,8,4,4,2023-01-13,2023-03-02,0,48
41081.0,505018,12,12,6,6,2022-12-20,2023-02-03,0,45
41144.0,505018,3,3,2,0,2022-12-23,2023-02-20,2,59
41151.0,616013,2,2,2,2,2023-02-20,2023-03-22,0,30
41272.0,505018,6,0,5,0,2023-01-23,2023-03-07,5,43
41272.0,505018,6,6,5,0,2023-01-23,2023-03-07,5,43
41272.0,505018,6,0,5,5,2023-01-23,2023-03-07,0,43
41272.0,505018,6,6,5,5,2023-01-23,2023-03-07,0,43
41288.0,504010,1,1,1,1,2023-02-22,2023-03-21,0,27
41288.0,505018,4,4,4,4,2023-02-22,2023-03-21,0,27
41303.0,14407,4,4,4,0,2023-01-13,2023-01-30,4,17
41303.0,725012,2,2,1,1,2023-01-13,2023-03-03,0,49
41303.0,8720790,6,6,2,2,2023-01-13,2023-03-01,0,47
41337.0,1AA3399,1,1,1,0,2023-03-14,2023-03-21,1,7
41354.0,5482401,5,5,5,5,2023-01-16,2023-03-13,0,56
41381.0,1AB1973,1,1,1,1,2023-01-16,2023-01-26,0,10
41403.0,6598405,4,4,4,4,2023-02-23,2023-03-06,0,11
41403.0,6623400,4,4,4,4,2023-02-23,2023-03-06,0,11
41407.0,24406,1,1,1,1,2023-02-07,2023-03-23,0,44
41415.0,367012,2,2,2,2,2023-01-05,2023-01-24,0,19
41415.0,378019,2,2,1,1,2023-01-05,2023-01-24,0,19
41515.0,505018,7,7,7,7,2023-01-30,2023-03-21,0,50
41515.0,571019,2,2,2,0,2023-03-28,2023-03-29,2,1
41523.0,829012,12,12,10,10,2023-02-17,2023-02-22,0,5
41523.0,1402403,40,40,35,35,2023-01-19,2023-03-02,0,42
41537.0,830019,2,2,2,2,2022-11-29,2023-01-23,0,55
41545.0,14407,4,4,3,3,2023-01-10,2023-03-09,0,58
41545.0,4520400,2,2,2,2,2023-01-10,2023-03-09,0,58
41575.0,313197,5,0,5,0,2022-12-15,2023-01-06,5,22
41575.0,315094,1,1,1,0,2022-12-15,2023-01-06,1,22
41575.0,504010,3,3,3,0,2023-02-03,2023-02-13,3,10
41590.0,97403,6,6,4,4,2023-01-18,2023-03-06,0,47
41590.0,5482401,4,0,4,4,2023-01-18,2023-03-06,0,47
41590.0,5482401,4,4,4,4,2023-01-18,2023-03-06,0,47
41590.0,8720790,4,4,2,2,2023-01-18,2023-03-06,0,47
41601.0,1AB2733,2,2,2,0,2023-02-09,2023-02-12,2,3
41601.0,1AB2735,2,2,2,0,2023-02-09,2023-02-12,2,3
41601.0,1AB2738,1,1,1,0,2023-02-09,2023-02-12,1,3
41601.0,1AB2739,1,1,1,0,2023-02-09,2023-02-12,1,3
41601.0,1AB2807,3,3,3,0,2023-02-09,2023-02-12,3,3
41637.0,14407,8,8,4,4,2022-12-19,2023-01-17,0,29
41637.0,97403,8,8,6,6,2022-12-19,2023-01-17,0,29
41701.0,504010,8,8,6,6,2023-01-23,2023-03-21,0,57
41701.0,505018,17,17,8,8,2023-01-23,2023-03-21,0,57
41701.0,829012,1,1,1,1,2023-02-09,2023-03-21,0,40
41711.0,5307401,9,0,9,0,2022-12-28,2023-01-17,9,20
41711.0,5307401,10,10,9,0,2023-01-17,2023-03-08,9,50
41754.0,725012,1,1,1,0,2023-01-06,2023-03-03,1,56
41764.0,504010,3,3,2,2,2023-02-16,2023-02-22,0,6
41764.0,504010,3,3,5,0,2023-02-16,2023-02-22,5,6
41764.0,505018,4,4,4,4,2023-02-16,2023-02-22,0,6
41764.0,505018,4,4,8,0,2023-02-16,2023-02-22,8,6
41778.0,542010,1,0,1,1,2023-01-17,2023-01-30,0,13
41778.0,543018,1,0,1,1,2023-01-17,2023-01-30,0,13
41778.0,546012,1,0,1,1,2023-01-17,2023-01-30,0,13
41858.0,5406,4,4,4,4,2023-02-22,2023-03-15,0,21
41858.0,11403,6,6,6,0,2023-02-22,2023-03-15,6,21
41858.0,11403,6,6,6,6,2023-02-22,2023-03-15,0,21
41858.0,369026,4,4,4,4,2023-02-22,2023-03-15,0,21
41858.0,390021,4,4,4,4,2023-02-22,2023-03-15,0,21
41858.0,1105403,6,6,6,6,2023-02-22,2023-03-15,0,21
41858.0,1105403,6,6,8,0,2023-02-22,2023-03-15,8,21
41858.0,4907400,4,4,4,4,2023-02-22,2023-03-15,0,21
41858.0,8720790,4,4,4,4,2023-02-22,2023-03-15,0,21
41858.0,8720790,4,4,8,0,2023-02-22,2023-03-15,8,21
41858.0,1AB2733,1,1,1,1,2023-02-22,2023-03-15,0,21
42013.0,1AB6168,1,1,1,0,2023-03-24,2023-03-29,1,5
42023.0,89400,3,3,3,3,2022-12-30,2023-01-09,0,10
42023.0,1105403,2,2,2,2,2022-12-30,2023-01-09,0,10
42023.0,4064408,3,3,3,3,2022-12-30,2023-01-09,0,10
42023.0,5482401,4,4,4,4,2022-12-30,2023-01-09,0,10
42029.0,97403,2,2,2,2,2023-02-02,2023-03-15,0,41
42029.0,505018,3,3,6,0,2023-03-15,2023-03-28,6,13
42064.0,1105403,9,9,9,0,2023-01-29,2023-03-07,9,37
42064.0,1105403,8,0,9,0,2023-01-29,2023-03-09,9,39
42080.0,505018,2,2,11,0,2023-02-05,2023-02-07,11,2
42080.0,505018,11,11,11,0,2023-02-05,2023-03-21,11,44
42080.0,505018,11,11,2,2,2023-02-07,2023-03-21,0,42
42115.0,829012,2,2,1,1,2022-11-05,2023-01-03,0,59
42117.0,9804015,1,1,1,0,2023-01-13,2023-02-01,1,19
42117.0,9809015,4,4,5,0,2023-01-13,2023-02-01,5,19
42122.0,504010,2,2,2,2,2023-02-28,2023-03-28,0,28
42122.0,505018,6,6,4,4,2023-02-28,2023-03-28,0,28
42122.0,6598405,4,4,4,0,2023-02-28,2023-03-27,4,27
42124.0,91488,14,14,14,14,2023-03-01,2023-03-03,0,2
42124.0,97403,8,8,8,8,2023-03-01,2023-03-03,0,2
42124.0,225012,1,1,1,1,2023-03-01,2023-03-03,0,2
42124.0,233023,3,3,3,3,2023-03-01,2023-03-03,0,2
42124.0,309170,1,1,1,1,2023-03-01,2023-03-03,0,2
42124.0,365016,1,1,1,1,2023-03-01,2023-03-03,0,2
42124.0,367012,1,1,1,1,2023-03-01,2023-03-03,0,2
42124.0,373019,1,1,1,1,2023-03-01,2023-03-03,0,2
42124.0,374025,1,1,1,1,2023-03-01,2023-03-03,0,2
42124.0,378019,1,1,1,1,2023-03-01,2023-03-03,0,2
42124.0,387028,2,2,2,2,2023-03-01,2023-03-03,0,2
42124.0,387036,1,1,1,1,2023-03-01,2023-03-03,0,2
42124.0,388018,2,2,2,2,2023-03-01,2023-03-03,0,2
42124.0,5307401,12,0,4,0,2022-12-02,2022-12-29,4,27
42124.0,5482401,17,17,17,17,2023-03-01,2023-03-03,0,2
42124.0,6598405,14,14,14,14,2023-03-01,2023-03-03,0,2
42124.0,6623400,6,6,6,6,2023-03-01,2023-03-03,0,2
42124.0,1AA0004,2,2,2,2,2023-03-01,2023-03-03,0,2
42132.0,1105403,5,5,3,3,2023-01-03,2023-01-13,0,10
42153.0,97403,10,10,5,5,2023-01-31,2023-03-13,0,41
42153.0,1402403,3,3,2,2,2023-01-31,2023-03-13,0,41
42156.0,97403,10,10,5,5,2023-01-25,2023-02-08,0,14
42191.0,201020,1,1,1,0,2022-12-01,2023-01-23,1,53
42191.0,504010,2,2,2,0,2023-01-03,2023-02-16,2,44
42191.0,505018,4,4,4,0,2023-01-03,2023-02-16,4,44
42193.0,8720790,2,2,2,0,2023-01-10,2023-01-19,2,9
42205.0,1402403,20,20,1,1,2023-01-05,2023-02-17,0,43
42227.0,504010,2,2,2,2,2023-01-03,2023-02-05,0,33
42229.0,542010,1,1,1,1,2022-12-27,2023-01-11,0,15
42229.0,543018,1,1,1,1,2022-12-27,2023-01-11,0,15
42229.0,548026,2,2,2,2,2022-12-27,2023-01-11,0,15
42229.0,549024,2,2,2,2,2022-12-27,2023-01-11,0,15
42229.0,741018,1,1,1,1,2022-12-27,2023-01-11,0,15
42269.0,6623400,4,4,4,0,2022-12-12,2023-02-03,4,53
42321.0,8720790,2,2,2,2,2023-01-30,2023-02-01,0,2
42321.0,1AB3459,8,8,5,5,2023-01-30,2023-02-01,0,2
42350.0,504010,2,2,1,1,2023-02-07,2023-03-13,0,34
42415.0,504010,5,5,5,5,2023-02-22,2023-03-20,0,26
42415.0,505018,10,10,8,8,2023-02-22,2023-03-20,0,26
42445.0,62349,3,3,3,0,2023-01-24,2023-03-03,3,38
42445.0,1AA0003,2,2,2,0,2023-01-24,2023-03-03,2,38
42465.0,14407,2,2,2,0,2023-02-28,2023-03-01,2,1
42465.0,82404,4,4,4,0,2023-02-28,2023-03-01,4,1
42465.0,91488,4,4,4,0,2023-02-28,2023-03-01,4,1
42465.0,8720774,4,4,4,0,2023-02-28,2023-03-01,4,1
42465.0,8720790,4,4,4,0,2023-02-28,2023-03-01,4,1
42465.0,1AB2919,5,5,5,5,2023-02-28,2023-03-01,0,1
42558.0,91488,22,0,8,8,2022-12-27,2023-02-09,0,44
42558.0,384016,5,5,5,0,2022-12-27,2023-02-09,5,44
42561.0,504010,3,0,3,3,2023-01-12,2023-03-08,0,55
42561.0,504010,3,0,3,3,2023-01-12,2023-03-08,0,55
42561.0,504010,3,3,3,0,2023-03-08,2023-03-17,3,9
42561.0,504010,3,3,3,0,2023-03-08,2023-03-17,3,9
42582.0,62349,4,4,4,4,2023-01-05,2023-03-06,0,60
42582.0,1412402,6,6,4,4,2023-01-05,2023-03-06,0,60
42597.0,504010,5,5,4,4,2022-12-20,2023-01-19,0,30
42597.0,505018,3,3,3,3,2022-12-20,2023-01-03,0,14
42597.0,505018,5,5,3,3,2022-12-20,2023-01-19,0,30
42597.0,505018,3,3,7,0,2022-12-20,2023-01-03,7,14
42597.0,505018,5,5,7,0,2022-12-20,2023-01-19,7,30
42597.0,505018,5,5,3,3,2023-01-03,2023-01-19,0,16
42597.0,505018,10,10,5,5,2023-01-19,2023-03-08,0,48
42600.0,504010,3,3,1,1,2023-01-23,2023-02-13,0,21
42600.0,505018,8,8,1,1,2023-01-23,2023-02-13,0,21
42706.0,367012,1,1,1,0,2023-03-28,2023-03-29,1,1
42706.0,369026,1,1,1,0,2023-03-28,2023-03-29,1,1
42706.0,373019,1,1,1,0,2023-03-28,2023-03-29,1,1
42706.0,8720790,2,2,2,0,2023-03-28,2023-03-29,2,1
42706.0,1AA0004,1,1,1,0,2023-03-28,2023-03-29,1,1
42739.0,526014,1,1,1,0,2022-12-20,2023-02-06,1,48
42739.0,527012,1,1,1,0,2022-12-20,2023-02-06,1,48
42739.0,528010,1,1,1,0,2022-12-20,2023-02-06,1,48
42739.0,661018,1,1,1,0,2022-12-20,2023-02-06,1,48
42739.0,8666408,1,0,3,0,2023-01-11,2023-02-06,3,26
42739.0,9088015,1,1,1,0,2022-12-20,2023-02-06,1,48
42764.0,369026,2,2,1,1,2023-01-17,2023-03-01,0,43
42764.0,376021,1,1,2,0,2023-01-17,2023-03-01,2,43
42832.0,91488,10,10,4,4,2023-01-18,2023-02-16,0,29
42832.0,91488,4,4,4,4,2023-01-18,2023-02-21,0,34
42832.0,91488,8,8,4,4,2023-01-18,2023-03-17,0,58
42832.0,91488,8,8,4,4,2023-02-21,2023-03-17,0,24
42832.0,97403,8,8,5,0,2022-12-24,2023-01-18,5,25
42832.0,97403,8,8,5,0,2022-12-24,2023-02-21,5,59
42832.0,97403,8,8,8,8,2023-01-18,2023-02-21,0,34
42832.0,367012,3,3,2,2,2023-01-18,2023-02-21,0,34
42832.0,367012,3,3,2,2,2023-01-18,2023-03-17,0,58
42832.0,367012,3,3,3,3,2023-02-21,2023-03-17,0,24
42832.0,374025,1,1,1,1,2023-01-18,2023-02-21,0,34
42832.0,374025,1,1,1,1,2023-01-18,2023-03-17,0,58
42832.0,374025,1,1,1,1,2023-02-21,2023-03-17,0,24
42832.0,378019,1,1,1,1,2023-02-21,2023-03-17,0,24
42832.0,387010,1,1,1,1,2023-02-21,2023-03-17,0,24
42832.0,387036,3,3,1,1,2023-01-18,2023-02-21,0,34
42832.0,387036,3,3,1,1,2023-01-18,2023-03-17,0,58
42832.0,387036,3,3,3,3,2023-02-21,2023-03-17,0,24
42832.0,2305135,2,2,2,2,2023-01-18,2023-02-21,0,34
42832.0,2305135,2,2,2,2,2023-01-18,2023-03-17,0,58
42832.0,2305135,2,2,2,2,2023-02-21,2023-03-17,0,24
42832.0,4520400,3,3,2,2,2023-01-18,2023-02-21,0,34
42832.0,4520400,2,2,2,2,2023-01-18,2023-03-17,0,58
42832.0,4907400,24,24,8,8,2023-01-03,2023-01-18,0,15
42832.0,4907400,17,17,8,8,2023-01-03,2023-02-21,0,49
42832.0,4907400,24,24,7,7,2023-03-03,2023-03-17,0,14
42832.0,4907400,24,24,24,24,2023-01-18,2023-03-17,0,58
42832.0,4907400,24,24,17,17,2023-02-21,2023-03-17,0,24
42832.0,5482401,20,20,25,0,2022-12-24,2023-01-18,25,25
42832.0,5482401,13,13,25,0,2022-12-24,2023-02-21,25,59
42832.0,5482401,20,20,7,7,2023-03-03,2023-03-17,0,14
42832.0,5482401,20,20,20,20,2023-01-18,2023-03-17,0,58
42832.0,5482401,20,20,13,13,2023-02-21,2023-03-17,0,24
42832.0,5736402,5,5,5,5,2023-01-18,2023-02-21,0,34
42832.0,6598405,4,4,4,4,2023-01-18,2023-02-21,0,34
42832.0,6598405,4,4,4,4,2023-01-18,2023-03-17,0,58
42832.0,6598405,4,4,4,4,2023-02-21,2023-03-17,0,24
42832.0,6623400,3,3,3,3,2023-01-18,2023-02-21,0,34
42832.0,6623400,4,4,3,3,2023-01-18,2023-03-17,0,58
42832.0,6623400,4,4,3,3,2023-02-21,2023-03-17,0,24
42848.0,1AB2733,5,5,8,0,2023-01-31,2023-02-08,8,8
42848.0,1AB2735,8,8,5,0,2023-01-31,2023-02-08,5,8
42848.0,1AB3457,3,3,1,0,2023-01-31,2023-02-08,1,8
42848.0,1AB3459,2,2,1,1,2023-01-31,2023-02-08,0,8
42848.0,1AB4571,8,8,6,0,2023-01-31,2023-02-08,6,8
43010.0,504010,2,2,1,1,2023-01-17,2023-02-27,0,41
43010.0,505018,7,7,3,3,2023-01-17,2023-02-27,0,41
43010.0,725590,2,2,2,0,2023-02-27,2023-03-27,2,28
43010.0,799207,1,1,1,0,2023-02-27,2023-03-27,1,28
43010.0,830019,1,1,1,1,2023-01-17,2023-03-01,0,43
43022.0,794009,1,1,1,0,2022-12-24,2023-02-14,1,52
43022.0,794009,1,1,1,0,2022-12-24,2023-02-14,1,52
43022.0,795001,1,1,1,0,2022-12-24,2023-02-14,1,52
43022.0,795001,1,1,1,0,2022-12-24,2023-02-14,1,52
43026.0,505018,7,7,7,0,2022-12-21,2023-01-13,7,23
43085.0,97403,4,4,2,2,2023-01-16,2023-03-08,0,51
43085.0,505018,2,2,2,0,2023-03-08,2023-03-15,2,7
43085.0,5482401,3,3,2,2,2022-12-21,2023-01-19,0,29
43085.0,5482401,2,2,2,2,2022-12-21,2023-01-16,0,26
43085.0,5482401,4,4,3,3,2023-01-19,2023-03-08,0,48
43085.0,5482401,4,4,3,3,2023-01-19,2023-03-08,0,48
43085.0,5482401,3,3,2,2,2023-01-16,2023-01-19,0,3
43085.0,5482401,4,4,2,2,2023-01-16,2023-03-08,0,51
43085.0,5482401,4,4,2,2,2023-01-16,2023-03-08,0,51
43085.0,6598405,2,2,2,2,2023-01-16,2023-03-08,0,51
43085.0,1AB2919,4,4,4,4,2022-12-21,2023-01-16,0,26
43087.0,6598405,10,10,10,10,2023-01-24,2023-02-17,0,24
43100.0,91421,5,5,5,5,2023-01-22,2023-02-22,0,31
43146.0,9804015,1,1,1,0,2023-02-12,2023-03-19,1,35
43146.0,9809015,4,0,4,0,2023-02-12,2023-03-19,4,35
43146.0,9809015,4,0,4,0,2023-02-12,2023-03-19,4,35
43146.0,9809015,4,4,4,0,2023-02-12,2023-03-19,4,35
43168.0,1105403,2,2,10,0,2023-02-09,2023-02-22,10,13
43224.0,97403,4,4,4,4,2022-12-09,2023-01-11,0,33
43224.0,5482401,6,6,6,6,2022-12-09,2023-01-11,0,33
43232.0,504010,2,2,2,2,2023-01-26,2023-03-16,0,49
43232.0,504010,3,3,2,2,2023-01-26,2023-02-15,0,20
43232.0,505018,4,4,2,2,2023-01-26,2023-03-16,0,49
43232.0,505018,5,5,2,2,2023-01-26,2023-02-15,0,20
43286.0,5406,3,0,3,0,2023-03-20,2023-03-27,3,7
43286.0,5482401,4,4,4,0,2023-03-20,2023-03-27,4,7
43300.0,387028,2,2,2,2,2023-02-02,2023-02-21,0,19
43300.0,1AA0004,2,2,2,2,2023-02-02,2023-02-21,0,19
43305.0,1105403,12,12,12,0,2023-01-23,2023-02-01,12,9
43306.0,14407,4,4,2,0,2023-02-08,2023-03-20,2,40
43306.0,97403,2,0,2,2,2023-02-08,2023-03-20,0,40
43377.0,57407,10,10,7,7,2023-01-16,2023-01-30,0,14
43377.0,97403,2,2,2,2,2023-01-16,2023-02-28,0,43
43377.0,5482401,6,6,7,0,2023-01-16,2023-02-28,7,43
43381.0,504010,2,2,2,2,2023-01-11,2023-01-13,0,2
43381.0,505018,5,5,3,3,2023-01-13,2023-02-05,0,23
43381.0,505018,3,3,2,2,2023-01-11,2023-01-13,0,2
43381.0,505018,5,5,2,2,2023-01-11,2023-02-05,0,25
43387.0,97403,4,4,2,2,2023-01-05,2023-02-24,0,50
43387.0,225012,3,3,2,0,2023-01-05,2023-02-24,2,50
43447.0,3704138,1,1,1,0,2023-03-06,2023-03-09,1,3
43447.0,5488409,3,3,3,0,2023-03-06,2023-03-09,3,3
43450.0,367012,1,0,1,0,2023-02-20,2023-03-13,1,21
43450.0,367012,1,1,1,0,2023-02-20,2023-03-13,1,21
43450.0,829012,2,0,1,0,2023-01-16,2023-02-20,1,35
43450.0,829012,2,2,1,0,2023-01-16,2023-03-13,1,56
43450.0,829012,2,2,2,0,2023-02-20,2023-03-13,2,21
43455.0,571019,2,2,1,1,2023-02-02,2023-03-09,0,35
43460.0,367012,2,0,2,0,2023-03-02,2023-03-07,2,5
43460.0,369026,1,0,2,0,2023-03-02,2023-03-07,2,5
43460.0,378019,1,0,1,0,2023-03-02,2023-03-07,1,5
43460.0,829012,1,1,1,1,2023-03-02,2023-03-07,0,5
43460.0,829012,1,1,1,0,2023-03-02,2023-03-07,1,5
43460.0,5482401,3,3,3,3,2023-03-02,2023-03-07,0,5
43460.0,8720790,1,1,1,1,2023-03-02,2023-03-07,0,5
43460.0,1AA0004,1,1,2,0,2023-03-02,2023-03-07,2,5
43475.0,829012,2,2,1,0,2023-02-15,2023-02-28,1,13
43475.0,5482401,4,4,4,4,2022-12-19,2023-02-15,0,58
43506.0,57407,4,4,4,4,2023-01-16,2023-03-15,0,58
43506.0,57407,4,4,4,4,2023-01-16,2023-02-22,0,37
43506.0,57407,4,4,4,4,2023-02-22,2023-03-15,0,21
43506.0,89400,14,14,10,0,2023-02-13,2023-03-14,10,29
43506.0,89400,10,10,10,0,2023-02-13,2023-02-16,10,3
43506.0,89400,14,14,10,10,2023-02-16,2023-03-14,0,26
43506.0,91488,4,4,4,4,2022-12-28,2023-01-16,0,19
43506.0,91488,5,5,4,4,2022-12-28,2023-02-08,0,42
43506.0,91488,4,4,4,4,2022-12-28,2023-02-22,0,56
43506.0,91488,4,4,4,4,2023-01-16,2023-03-15,0,58
43506.0,91488,5,5,4,4,2023-01-16,2023-02-08,0,23
43506.0,91488,4,4,4,4,2023-01-16,2023-02-22,0,37
43506.0,91488,4,4,4,4,2023-02-22,2023-03-15,0,21
43506.0,97403,18,18,18,18,2023-01-13,2023-03-14,0,60
43506.0,97403,18,18,18,18,2023-01-13,2023-02-13,0,31
43506.0,97403,18,18,18,18,2023-02-13,2023-03-14,0,29
43506.0,1676404,2,2,2,0,2023-03-14,2023-03-25,2,11
43506.0,4907400,13,13,10,10,2023-02-13,2023-03-14,0,29
43506.0,5307401,2,0,2,0,2023-01-13,2023-01-20,2,7
43506.0,5307401,3,0,2,0,2023-01-13,2023-02-13,2,31
43506.0,5307401,3,0,2,0,2023-01-13,2023-02-16,2,34
43506.0,5307401,3,0,2,0,2023-01-20,2023-02-13,2,24
43506.0,5307401,3,0,2,0,2023-01-20,2023-02-16,2,27
43506.0,5307401,3,0,3,0,2023-02-13,2023-02-16,3,3
43506.0,6179403,8,8,4,4,2023-01-13,2023-03-14,0,60
43506.0,6179403,8,8,3,3,2023-02-13,2023-03-14,0,29
43506.0,1AB2691,2,2,2,2,2023-02-13,2023-03-14,0,29
43530.0,5482401,3,3,3,3,2023-01-10,2023-02-22,0,43
43583.0,97403,4,4,4,4,2023-02-22,2023-03-27,0,33
43583.0,97403,9,9,4,4,2023-02-22,2023-03-27,0,33
43592.0,504010,3,3,1,1,2023-01-10,2023-02-28,0,49
43592.0,505018,8,8,4,4,2023-01-10,2023-02-28,0,49
43597.0,8717714,1,1,1,0,2023-01-12,2023-01-16,1,4
43602.0,504010,1,1,1,1,2023-01-25,2023-03-09,0,43
43602.0,504010,3,3,1,1,2023-01-25,2023-02-13,0,19
43602.0,505018,3,3,3,3,2023-01-25,2023-03-09,0,43
43602.0,505018,6,6,3,3,2023-01-25,2023-02-13,0,19
43617.0,1402403,2,2,2,2,2023-02-08,2023-03-24,0,44
43618.0,14407,4,4,4,0,2023-01-05,2023-01-15,4,10
43634.0,1AB3458,2,2,1,1,2023-02-20,2023-03-13,0,21
43635.0,1AB3458,1,1,1,1,2023-01-17,2023-03-09,0,51
43665.0,394106,1,1,1,0,2023-01-03,2023-01-19,1,16
43665.0,504010,3,3,3,3,2023-01-04,2023-02-14,0,41
43665.0,504010,3,3,3,3,2023-02-14,2023-03-24,0,38
43665.0,505018,7,7,7,7,2023-01-04,2023-02-14,0,41
43665.0,505018,8,8,7,7,2023-02-14,2023-03-24,0,38
43671.0,505018,4,4,4,0,2023-01-15,2023-03-06,4,50
43682.0,14407,2,2,2,0,2023-02-06,2023-02-14,2,8
43682.0,570094,1,0,1,1,2023-02-06,2023-02-14,0,8
43696.0,97403,4,4,4,4,2022-12-27,2023-01-31,0,35
43696.0,829012,1,0,1,1,2022-12-27,2023-01-31,0,35
43696.0,5482401,3,3,2,2,2022-12-27,2023-01-31,0,35
43698.0,504010,1,1,1,1,2023-02-20,2023-02-23,0,3
43698.0,505018,3,3,3,3,2023-02-20,2023-02-23,0,3
43718.0,829012,10,10,10,10,2023-02-03,2023-03-13,0,38
43778.0,1105403,4,4,4,0,2023-02-02,2023-02-09,4,7
43778.0,1AA0004,3,3,3,0,2023-02-02,2023-02-09,3,7
43806.0,829012,2,2,1,0,2023-01-13,2023-03-06,1,52
43806.0,829012,2,2,1,1,2023-01-13,2023-03-06,0,52
43816.0,505018,12,0,4,4,2023-02-21,2023-03-26,0,33
43889.0,97403,1,1,1,0,2023-02-06,2023-02-28,1,22
43889.0,5482401,2,2,8,0,2022-12-28,2023-02-06,8,40
43889.0,6598405,1,1,1,0,2023-02-06,2023-02-28,1,22
43889.0,6623400,2,2,1,1,2022-12-28,2023-02-06,0,40
43889.0,8720790,1,1,1,0,2023-02-06,2023-02-28,1,22
43889.0,1AB2733,1,1,1,0,2023-02-06,2023-02-28,1,22
43889.0,1AB2735,1,1,1,0,2023-02-06,2023-02-28,1,22
43903.0,5406,7,7,5,5,2023-02-21,2023-03-15,0,22
43903.0,369026,7,7,5,5,2023-02-21,2023-03-15,0,22
43903.0,390021,7,7,1,1,2023-02-21,2023-03-15,0,22
43935.0,4226404,1,1,1,0,2023-01-09,2023-01-18,1,9
43935.0,6179403,3,3,3,0,2023-01-09,2023-01-18,3,9
43935.0,1AB2691,2,2,2,0,2023-01-09,2023-01-18,2,9
43947.0,364026,1,1,1,1,2023-02-02,2023-03-28,0,54
43967.0,5406,4,4,4,4,2023-02-08,2023-03-27,0,47
43967.0,11403,4,4,3,3,2023-02-08,2023-03-27,0,47
43967.0,97403,5,5,4,4,2023-02-08,2023-03-27,0,47
43967.0,5482401,6,6,6,6,2023-02-09,2023-03-27,0,46
44021.0,14407,3,3,3,0,2023-01-13,2023-01-30,3,17
44021.0,14407,2,2,3,0,2023-01-13,2023-03-14,3,60
44021.0,97403,2,2,2,2,2023-01-13,2023-03-14,0,60
44021.0,504010,2,2,2,2,2023-01-13,2023-03-14,0,60
44021.0,505018,6,6,2,2,2023-01-13,2023-03-14,0,60
44021.0,5482401,5,5,5,0,2023-01-13,2023-01-30,5,17
44021.0,5482401,6,6,5,0,2023-01-13,2023-03-14,5,60
44021.0,5482401,6,6,5,5,2023-01-30,2023-03-14,0,43
44021.0,8720790,1,0,1,0,2023-01-13,2023-01-30,1,17
44021.0,8720790,3,0,1,0,2023-01-13,2023-03-14,1,60
44021.0,8720790,3,0,1,0,2023-01-30,2023-03-14,1,43
44054.0,58405,2,2,2,0,2023-02-13,2023-02-20,2,7
44054.0,5482401,4,4,8,0,2023-02-13,2023-02-20,8,7
44054.0,8717714,1,1,1,0,2023-02-13,2023-02-20,1,7
44062.0,571019,2,2,1,1,2023-02-01,2023-02-27,0,26
44072.0,6598405,4,4,4,0,2023-02-17,2023-02-27,4,10
44130.0,1412402,3,3,2,0,2023-03-07,2023-03-15,2,8
44150.0,374025,1,1,2,0,2023-01-23,2023-02-28,2,36
44196.0,56409,8,0,7,7,2023-01-13,2023-02-21,0,39
44196.0,4608404,4,0,4,4,2023-01-13,2023-02-21,0,39
44196.0,1AA8981,1,1,1,0,2023-01-13,2023-02-21,1,39
44310.0,14407,6,0,6,0,2023-02-01,2023-03-20,6,47
44310.0,14407,6,6,6,0,2023-02-01,2023-03-20,6,47
44317.0,8720790,4,4,4,0,2023-01-20,2023-01-25,4,5
44320.0,62349,2,2,2,2,2023-01-24,2023-03-06,0,41
44320.0,6179403,4,4,4,4,2023-01-24,2023-03-06,0,41
44325.0,8400,1,1,1,0,2023-03-06,2023-03-15,1,9
44325.0,57407,10,10,6,6,2023-01-10,2023-01-25,0,15
44325.0,89400,16,16,3,0,2022-12-18,2023-01-04,3,17
44325.0,89400,3,3,3,0,2022-12-18,2023-01-24,3,37
44325.0,89400,9,9,3,3,2023-01-24,2023-03-06,0,41
44325.0,91488,6,6,6,6,2023-01-10,2023-01-25,0,15
44325.0,233023,1,1,1,0,2023-02-09,2023-03-06,1,25
44325.0,233023,1,1,1,0,2023-02-09,2023-03-06,1,25
44325.0,367012,1,1,1,1,2022-12-18,2023-01-04,0,17
44325.0,1676404,3,3,3,3,2023-03-10,2023-03-15,0,5
44325.0,4520400,2,2,2,2,2022-12-18,2023-01-04,0,17
44325.0,5307401,3,0,3,0,2023-03-06,2023-03-10,3,4
44325.0,5482401,6,6,6,6,2022-12-18,2023-01-04,0,17
44325.0,5482401,2,2,2,0,2023-03-06,2023-03-15,2,9
44325.0,5488409,5,0,5,0,2023-03-06,2023-03-15,5,9
44325.0,5736402,4,4,4,0,2023-03-06,2023-03-15,4,9
44325.0,5963336,10,10,12,0,2022-12-18,2023-01-04,12,17
44325.0,1AB2691,1,1,1,1,2022-12-18,2023-01-04,0,17
44325.0,1AB2692,1,1,1,1,2022-12-18,2023-01-04,0,17
44383.0,97403,12,12,3,3,2023-01-20,2023-02-09,0,20
44383.0,97403,12,12,3,3,2023-01-20,2023-03-08,0,47
44383.0,97403,12,12,12,12,2023-02-09,2023-03-08,0,27
44383.0,388018,1,1,1,1,2023-02-09,2023-03-08,0,27
44383.0,1679408,6,0,2,2,2022-12-16,2023-01-11,0,26
44383.0,1679408,5,5,2,2,2022-12-16,2023-01-05,0,20
44383.0,1679408,6,0,5,5,2023-01-05,2023-01-11,0,6
44383.0,2305135,8,8,8,8,2023-01-20,2023-02-09,0,20
44383.0,2305135,92,92,8,8,2023-01-20,2023-03-08,0,47
44383.0,2305135,92,92,8,8,2023-02-09,2023-03-08,0,27
44383.0,5307401,10,0,4,0,2022-10-31,2022-12-20,4,50
44383.0,5307401,10,0,10,0,2022-12-20,2023-01-20,10,31
44383.0,5307401,6,0,10,0,2022-12-20,2023-01-11,10,22
44383.0,5307401,2,0,10,0,2022-12-20,2023-02-09,10,51
44383.0,5307401,2,0,10,0,2023-01-20,2023-02-09,10,20
44383.0,5307401,10,0,6,0,2023-01-11,2023-01-20,6,9
44383.0,5307401,2,0,6,0,2023-01-11,2023-02-09,6,29
44383.0,5482401,16,16,16,16,2023-01-20,2023-02-09,0,20
44383.0,6598405,24,0,24,24,2023-01-20,2023-03-08,0,47
44383.0,6598405,24,0,20,20,2023-02-09,2023-03-08,0,27
44383.0,6623400,8,8,6,6,2023-01-20,2023-02-09,0,20
44409.0,91488,6,6,6,6,2022-12-27,2023-02-10,0,45
44409.0,97403,9,9,6,6,2022-12-27,2023-02-10,0,45
44409.0,367012,3,3,2,2,2022-12-30,2023-02-14,0,46
44409.0,367012,2,2,2,2,2022-12-30,2023-02-10,0,42
44409.0,367012,2,2,2,2,2022-12-27,2022-12-30,0,3
44409.0,367012,3,3,2,2,2022-12-27,2023-02-14,0,49
44409.0,367012,2,2,2,2,2022-12-27,2023-02-10,0,45
44409.0,367012,3,3,2,2,2023-02-10,2023-02-14,0,4
44409.0,2305135,5,5,5,5,2022-12-27,2023-02-10,0,45
44409.0,4520400,2,2,2,2,2022-12-27,2023-02-10,0,45
44409.0,4907400,60,60,24,24,2022-12-30,2023-02-10,0,42
44409.0,4907400,60,60,36,36,2022-12-27,2023-02-10,0,45
44409.0,5482401,40,40,40,40,2022-12-27,2023-02-10,0,45
44409.0,5963336,2,2,2,2,2022-12-27,2023-02-10,0,45
44409.0,6598405,3,3,2,2,2022-12-27,2023-02-10,0,45
44409.0,6623400,3,3,2,2,2022-12-27,2023-02-10,0,45
44482.0,505018,3,3,3,0,2023-01-11,2023-01-25,3,14
44482.0,505018,3,3,3,0,2023-01-11,2023-01-25,3,14
44482.0,4608404,6,6,6,0,2023-01-11,2023-01-25,6,14
44483.0,504010,1,1,1,1,2023-01-18,2023-01-24,0,6
44483.0,5482401,6,6,4,4,2023-01-16,2023-01-19,0,3
44504.0,741018,1,1,1,0,2023-02-20,2023-03-03,1,11
44547.0,505018,4,4,1,1,2023-02-21,2023-03-22,0,29
44547.0,505018,4,4,5,0,2023-02-21,2023-03-22,5,29
44547.0,9511404,3,3,2,2,2023-02-21,2023-03-01,0,8
44554.0,2306265,3,3,3,3,2023-02-20,2023-03-20,0,28
44556.0,14407,8,8,14,0,2023-01-25,2023-02-14,14,20
44566.0,82404,8,8,1,0,2023-01-18,2023-03-06,1,47
44644.0,97403,8,8,4,4,2023-01-10,2023-03-06,0,55
44644.0,504010,5,5,5,5,2023-01-20,2023-03-08,0,47
44644.0,505018,7,7,5,5,2023-01-20,2023-03-08,0,47
44648.0,2256106,1,0,1,1,2023-03-02,2023-03-13,0,11
44648.0,5482401,10,10,5,5,2023-03-02,2023-03-13,0,11
44648.0,6179403,3,3,2,2,2023-03-02,2023-03-13,0,11
44648.0,6598405,3,3,3,3,2023-03-02,2023-03-13,0,11
44648.0,8717714,1,1,1,1,2023-03-02,2023-03-13,0,11
44670.0,504010,4,4,3,3,2023-01-19,2023-02-27,0,39
44716.0,504010,1,1,1,1,2023-02-28,2023-03-16,0,16
44716.0,505018,3,3,3,3,2023-02-28,2023-03-16,0,16
44731.0,504010,2,2,2,2,2023-03-16,2023-03-21,0,5
44731.0,505018,4,4,4,4,2023-03-16,2023-03-21,0,5
44735.0,6979407,6,0,5,5,2023-01-04,2023-02-24,0,51
44735.0,6979407,6,0,5,5,2023-01-04,2023-02-24,0,51
44767.0,5482401,2,2,2,2,2023-01-20,2023-03-16,0,55
44787.0,5406,4,4,2,2,2023-01-03,2023-02-21,0,49
44826.0,1105403,4,4,4,0,2023-01-09,2023-02-20,4,42
44826.0,1401405,4,4,2,0,2023-01-09,2023-02-20,2,42
44826.0,9511404,4,4,2,0,2023-01-09,2023-02-20,2,42
44858.0,367012,6,6,2,2,2023-01-06,2023-02-02,0,27
44965.0,504010,8,8,5,5,2023-02-01,2023-03-23,0,50
44965.0,505018,12,12,10,10,2023-02-01,2023-03-23,0,50
44966.0,504010,2,2,1,0,2023-01-23,2023-03-08,1,44
44967.0,14407,4,4,4,0,2023-01-27,2023-02-20,4,24
44967.0,1AB2735,6,6,6,6,2023-01-26,2023-01-27,0,1
44969.0,14407,4,4,4,4,2023-01-11,2023-02-09,0,29
45026.0,367012,1,1,1,1,2023-01-27,2023-03-21,0,53
45042.0,1AB3456,6,6,6,0,2023-02-17,2023-03-08,6,19
45042.0,1AB4571,6,6,1,1,2023-02-17,2023-03-08,0,19
45074.0,1401405,8,0,6,0,2022-12-13,2023-02-10,6,59
45074.0,1402403,8,8,6,6,2022-12-13,2023-02-10,0,59
45074.0,1402403,10,10,6,6,2022-12-13,2023-01-10,0,28
45074.0,6598405,6,6,4,4,2023-01-10,2023-02-10,0,31
45121.0,373019,2,2,2,0,2023-01-23,2023-02-27,2,35
45131.0,504010,8,8,8,8,2023-01-25,2023-03-09,0,43
45131.0,505018,18,18,16,16,2023-01-25,2023-03-09,0,43
45144.0,504010,3,3,2,2,2022-12-28,2023-01-30,0,33
45144.0,505018,5,5,5,5,2022-12-28,2023-01-30,0,33
45144.0,505018,5,5,5,5,2023-01-30,2023-03-27,0,56
45238.0,725012,4,4,4,0,2023-01-20,2023-01-30,4,10
45238.0,830019,12,12,3,3,2023-01-20,2023-01-30,0,10
45257.0,8720774,1,1,1,0,2022-11-22,2023-01-13,1,52
45258.0,504010,6,6,6,6,2023-01-03,2023-02-22,0,50
45258.0,5482401,6,6,4,4,2023-01-27,2023-02-22,0,26
45280.0,505018,6,6,3,3,2023-01-16,2023-03-10,0,53
45281.0,97403,6,6,3,3,2022-12-13,2023-02-06,0,55
45281.0,5482401,6,6,3,3,2022-12-13,2023-02-06,0,55
45296.0,504010,4,4,4,4,2023-01-07,2023-03-08,0,60
45307.0,4757409,3,0,3,0,2022-12-08,2023-01-12,3,35
45307.0,4757409,5,5,3,0,2023-01-12,2023-03-03,3,50
45379.0,91488,10,10,5,5,2023-01-05,2023-01-31,0,26
45379.0,97403,2,2,1,1,2023-03-02,2023-03-03,0,1
45379.0,5480405,10,10,10,0,2023-01-31,2023-03-16,10,44
45474.0,97403,2,2,2,0,2023-02-14,2023-02-20,2,6
45474.0,97403,2,2,2,2,2023-02-14,2023-02-20,0,6
45474.0,374025,2,0,2,2,2023-02-14,2023-02-20,0,6
45474.0,387028,3,3,3,3,2023-02-14,2023-02-20,0,6
45474.0,3029395,2,2,2,2,2023-01-18,2023-02-20,0,33
45474.0,8717714,1,1,1,1,2023-01-18,2023-02-20,0,33
45474.0,8720774,1,1,1,1,2023-01-18,2023-02-20,0,33
45474.0,8720790,3,3,3,3,2023-01-18,2023-02-20,0,33
45474.0,1AA0004,1,1,1,1,2023-02-14,2023-02-20,0,6
45474.0,1AB2735,2,2,2,2,2023-02-14,2023-02-20,0,6
45524.0,504010,3,3,3,0,2023-01-17,2023-01-20,3,3
45524.0,505018,6,6,6,0,2023-01-17,2023-01-20,6,3
45524.0,546053,1,0,1,0,2023-01-17,2023-01-31,1,14
45524.0,575011,1,1,1,0,2023-01-17,2023-01-31,1,14
45524.0,666018,14,14,11,11,2023-01-17,2023-01-31,0,14
45524.0,725012,1,1,1,0,2023-01-17,2023-01-20,1,3
45535.0,5406,10,10,10,0,2023-02-08,2023-02-21,10,13
45535.0,24406,10,10,10,0,2023-02-08,2023-02-21,10,13
45547.0,504010,4,4,2,2,2023-01-10,2023-03-03,0,52
45547.0,505018,8,8,2,2,2023-01-10,2023-03-03,0,52
45547.0,2305135,16,16,10,10,2023-01-10,2023-03-03,0,52
45556.0,504010,3,0,3,3,2023-01-06,2023-02-06,0,31
45556.0,505018,6,0,5,5,2023-01-06,2023-02-06,0,31
45573.0,2306265,4,4,4,4,2023-01-09,2023-02-03,0,25
45575.0,5406,11,11,3,3,2023-01-11,2023-03-02,0,50
45629.0,62349,2,2,2,2,2023-02-03,2023-03-06,0,31
45629.0,504010,2,2,2,2,2023-02-03,2023-03-06,0,31
45629.0,505018,6,6,2,2,2023-02-03,2023-03-06,0,31
45631.0,5482401,3,3,2,2,2022-11-08,2022-12-13,0,35
45680.0,200538,5,0,5,5,2023-02-13,2023-03-06,0,21
45680.0,9803017,1,0,1,1,2023-02-13,2023-03-06,0,21
45680.0,9804015,1,1,1,0,2023-02-13,2023-03-06,1,21
45680.0,9807019,2,0,2,2,2023-02-13,2023-03-06,0,21
45680.0,9809015,5,5,5,0,2023-02-13,2023-03-06,5,21
45727.0,373019,2,2,3,1,2023-01-11,2023-01-18,2,7
45727.0,6923016,8,8,2,2,2023-01-08,2023-01-18,0,10
45752.0,24406,2,2,2,0,2023-01-09,2023-01-23,2,14
45752.0,1AB2733,1,1,1,0,2022-12-22,2022-12-29,1,7
45752.0,1AB6168,1,1,1,0,2022-12-22,2022-12-29,1,7
45754.0,97403,6,6,5,5,2023-01-20,2023-02-16,0,27
45754.0,5482401,5,5,5,5,2023-01-20,2023-02-16,0,27
45754.0,6598405,7,7,5,5,2023-01-20,2023-02-16,0,27
45782.0,3029395,2,2,2,0,2022-12-14,2022-12-19,2,5
45782.0,3029395,2,2,2,0,2022-12-14,2022-12-19,2,5
45812.0,91488,12,12,12,0,2023-02-14,2023-02-16,12,2
45840.0,24406,3,3,3,3,2023-01-06,2023-01-15,0,9
45874.0,14407,4,4,4,0,2023-01-10,2023-01-24,4,14
45928.0,11403,2,2,2,2,2023-01-20,2023-02-15,0,26
45928.0,829012,2,0,2,0,2022-12-23,2023-02-15,2,54
45928.0,829012,2,2,2,0,2022-12-23,2023-02-15,2,54
45928.0,829012,2,0,2,2,2022-12-23,2023-02-15,0,54
45928.0,829012,2,2,2,2,2022-12-23,2023-02-15,0,54
45928.0,829012,3,3,2,0,2023-02-15,2023-03-14,2,27
45928.0,829012,3,3,2,2,2023-02-15,2023-03-14,0,27
45928.0,3029395,1,0,1,0,2023-02-15,2023-03-03,1,16
46030.0,725012,1,1,1,0,2023-01-05,2023-01-09,1,4
46037.0,829012,1,1,1,0,2023-03-03,2023-03-15,1,12
46043.0,505018,8,0,8,0,2023-01-09,2023-03-06,8,56
46043.0,5482401,2,2,8,0,2023-01-09,2023-03-06,8,56
46069.0,14407,4,4,4,0,2022-11-23,2023-01-10,4,48
46069.0,4608404,4,4,4,0,2022-11-23,2023-01-10,4,48
46079.0,5482401,8,8,6,6,2023-01-03,2023-02-27,0,55
46117.0,97403,10,10,10,10,2023-01-04,2023-02-13,0,40
46117.0,1AB2733,5,5,5,5,2023-01-04,2023-02-13,0,40
46215.0,14407,3,0,3,0,2023-01-20,2023-02-01,3,12
46215.0,1401405,1,1,1,0,2023-01-20,2023-02-01,1,12
46225.0,7402,6,0,6,0,2022-12-27,2023-01-04,6,8
46225.0,365016,2,0,2,0,2022-12-27,2023-01-04,2,8
46225.0,378019,2,0,2,0,2022-12-27,2023-01-04,2,8
46225.0,6598405,22,22,7,7,2022-12-27,2023-01-04,0,8
46225.0,6623400,5,5,8,0,2022-12-27,2023-01-04,8,8
46228.0,504010,2,2,2,2,2023-01-10,2023-02-01,0,22
46228.0,505018,8,8,2,2,2023-01-10,2023-02-01,0,22
46228.0,829012,2,0,2,0,2023-01-10,2023-02-01,2,22
46228.0,829012,1,1,2,0,2023-01-10,2023-02-26,2,47
46228.0,829012,1,1,2,0,2023-02-01,2023-02-26,2,25
46235.0,5482401,4,4,4,4,2023-01-18,2023-02-08,0,21
46237.0,97403,6,6,6,6,2023-01-26,2023-03-02,0,35
46301.0,374025,1,1,1,0,2022-12-29,2023-02-17,1,50
46305.0,367012,3,3,3,0,2023-02-09,2023-02-20,3,11
46309.0,8720790,4,4,4,0,2023-03-20,2023-03-23,4,3
46325.0,57407,18,18,4,4,2023-01-17,2023-02-21,0,35
46325.0,57407,18,18,14,14,2023-01-16,2023-02-21,0,36
46325.0,89400,12,12,12,12,2023-02-20,2023-03-27,0,35
46325.0,91488,12,12,4,4,2023-01-17,2023-02-21,0,35
46325.0,367012,2,2,2,2,2023-02-20,2023-03-27,0,35
46325.0,6179403,6,6,4,4,2023-01-09,2023-02-20,0,42
46325.0,1AA0004,2,2,2,2,2023-01-09,2023-02-20,0,42
46325.0,1AA0004,2,2,2,2,2023-02-20,2023-03-27,0,35
46415.0,5406,12,12,12,0,2023-01-11,2023-01-28,12,17
46450.0,505018,10,10,10,10,2023-01-22,2023-03-10,0,47
46468.0,24406,2,2,2,2,2023-01-23,2023-02-14,0,22
46468.0,6598405,6,6,5,5,2023-01-23,2023-02-14,0,22
46468.0,6623400,4,4,4,4,2023-01-23,2023-02-14,0,22
46533.0,1240407,1,1,2,0,2023-01-04,2023-02-06,2,33
46533.0,1402403,2,0,2,0,2023-01-04,2023-02-06,2,33
46533.0,8720790,5,5,5,0,2023-01-04,2023-02-06,5,33
46533.0,9511404,1,1,1,0,2023-01-04,2023-02-06,1,33
46592.0,1AB2919,8,8,5,5,2023-02-06,2023-03-27,0,49
46611.0,91488,4,4,2,2,2022-12-24,2023-01-16,0,23
46611.0,91488,2,2,2,2,2022-12-24,2023-02-13,0,51
46611.0,91488,2,2,2,2,2023-02-13,2023-03-15,0,30
46611.0,97403,4,4,4,4,2023-02-13,2023-03-15,0,30
46611.0,367012,2,2,1,1,2023-01-16,2023-02-13,0,28
46611.0,387010,1,1,1,1,2022-12-24,2023-02-13,0,51
46611.0,1676404,4,4,2,2,2022-12-28,2023-01-26,0,29
46611.0,1676404,4,4,4,4,2023-01-26,2023-03-15,0,48
46611.0,1679408,8,8,2,2,2022-12-22,2023-01-03,0,12
46611.0,1679408,12,12,8,8,2023-01-03,2023-02-27,0,55
46611.0,4520400,4,4,2,2,2022-12-24,2023-01-16,0,23
46611.0,4520400,2,2,2,2,2022-12-24,2023-02-13,0,51
46611.0,4520400,2,2,2,2,2023-02-13,2023-03-15,0,30
46611.0,4907400,28,28,28,28,2022-12-24,2023-01-16,0,23
46611.0,4907400,28,28,28,28,2022-12-24,2023-02-13,0,51
46611.0,4907400,28,28,28,28,2023-01-16,2023-02-13,0,28
46611.0,4907400,28,28,28,28,2023-01-16,2023-03-15,0,58
46611.0,4907400,28,28,28,28,2023-02-13,2023-03-15,0,30
46611.0,5307401,2,0,2,0,2022-12-24,2022-12-28,2,4
46611.0,5307401,8,0,2,0,2022-12-24,2023-01-16,2,23
46611.0,5307401,4,0,2,0,2022-12-24,2023-01-26,2,33
46611.0,5307401,8,0,2,0,2022-12-28,2023-01-16,2,19
46611.0,5307401,4,0,2,0,2022-12-28,2023-01-26,2,29
46611.0,5307401,4,0,8,0,2023-01-16,2023-01-26,8,10
46611.0,5482401,20,20,16,16,2022-12-24,2023-01-16,0,23
46611.0,5482401,25,25,16,16,2022-12-24,2023-02-13,0,51
46611.0,5482401,25,25,20,20,2023-01-16,2023-02-13,0,28
46611.0,5482401,25,25,20,20,2023-01-16,2023-03-15,0,58
46611.0,5482401,25,25,25,25,2023-02-13,2023-03-15,0,30
46611.0,6598405,14,14,14,14,2022-12-24,2023-01-16,0,23
46611.0,6598405,12,12,10,10,2023-02-13,2023-03-15,0,30
46611.0,6623400,5,5,4,4,2022-12-24,2023-01-16,0,23
46611.0,6623400,4,4,2,2,2023-02-13,2023-03-15,0,30
46611.0,6968020,3,3,1,1,2023-01-16,2023-02-13,0,28
46611.0,6968038,3,3,1,1,2023-01-16,2023-02-13,0,28
46649.0,1AB3456,3,3,3,3,2023-01-19,2023-03-02,0,42
46649.0,1AB4571,6,6,6,6,2023-01-19,2023-03-02,0,42
46705.0,1AA0004,3,3,1,1,2023-02-02,2023-02-23,0,21
46763.0,14407,4,4,4,0,2023-02-06,2023-02-20,4,14
46763.0,24406,3,3,3,0,2023-02-06,2023-02-20,3,14
46763.0,97403,4,4,4,0,2023-02-06,2023-02-20,4,14
46787.0,5406,6,6,4,0,2023-02-17,2023-03-17,4,28
46787.0,5406,2,2,4,0,2023-02-17,2023-03-17,4,28
46787.0,91488,1,1,1,1,2023-02-17,2023-03-17,0,28
46787.0,97403,4,4,2,0,2023-02-17,2023-03-17,2,28
46787.0,373019,2,2,2,2,2023-02-17,2023-03-17,0,28
46787.0,1402403,4,4,4,4,2023-02-17,2023-03-17,0,28
46787.0,4520400,1,1,1,1,2023-02-17,2023-03-17,0,28
46787.0,5482401,8,8,8,8,2023-02-17,2023-03-17,0,28
46830.0,504010,3,3,3,3,2022-12-12,2023-01-30,0,49
46842.0,358011,1,1,1,1,2023-01-10,2023-02-03,0,24
46842.0,505018,17,17,17,0,2023-01-30,2023-02-03,17,4
46850.0,374025,1,1,2,0,2023-01-17,2023-01-31,2,14
46857.0,504010,3,0,2,2,2023-02-15,2023-02-28,0,13
46900.0,14407,2,2,2,2,2023-01-19,2023-02-24,0,36
46900.0,526014,1,1,1,0,2023-01-10,2023-01-19,1,9
46900.0,526014,1,1,1,0,2023-01-10,2023-01-19,1,9
46900.0,1412402,6,6,5,5,2023-01-19,2023-02-24,0,36
46900.0,5482401,2,2,2,2,2023-01-19,2023-02-24,0,36
46927.0,89400,8,8,5,5,2022-12-13,2023-02-01,0,50
46927.0,89400,8,8,2,2,2023-01-13,2023-02-01,0,19
46927.0,89400,10,10,2,2,2023-01-13,2023-02-27,0,45
46927.0,89400,10,10,8,8,2023-02-01,2023-02-27,0,26
46927.0,97403,11,11,7,7,2022-12-13,2023-02-07,0,56
46927.0,97403,10,10,4,4,2023-02-01,2023-02-27,0,26
46927.0,97403,11,11,4,4,2023-02-01,2023-02-07,0,6
46927.0,233023,1,1,1,1,2023-02-01,2023-02-27,0,26
46927.0,367012,2,2,2,2,2022-12-13,2023-02-01,0,50
46927.0,367012,2,2,2,2,2023-02-01,2023-02-27,0,26
46927.0,378019,2,2,2,2,2022-12-13,2023-02-01,0,50
46927.0,4907400,12,12,8,8,2022-12-13,2023-01-13,0,31
46927.0,4907400,15,0,8,8,2022-12-13,2023-02-01,0,50
46927.0,4907400,35,35,8,8,2022-12-13,2023-02-07,0,56
46927.0,4907400,15,0,12,12,2023-01-13,2023-02-01,0,19
46927.0,4907400,25,25,12,12,2023-01-13,2023-02-27,0,45
46927.0,4907400,35,35,12,12,2023-01-13,2023-02-07,0,25
46927.0,4907400,25,25,15,0,2023-02-01,2023-02-27,15,26
46927.0,4907400,35,35,15,0,2023-02-01,2023-02-07,15,6
46927.0,5307401,10,0,10,0,2023-02-01,2023-02-07,10,6
46927.0,6179403,6,6,6,6,2022-12-13,2023-02-01,0,50
46927.0,6179403,8,8,6,6,2023-02-01,2023-02-27,0,26
46927.0,6179403,8,8,2,2,2023-02-07,2023-02-27,0,20
46927.0,6179403,5,5,2,2,2023-02-07,2023-03-16,0,37
46927.0,6598405,15,15,8,8,2022-12-13,2023-02-01,0,50
46927.0,6598405,8,8,7,7,2023-02-27,2023-03-16,0,17
46931.0,233023,1,1,1,0,2023-02-02,2023-02-22,1,20
46931.0,313197,1,1,1,0,2023-02-02,2023-02-22,1,20
46931.0,315094,1,1,2,0,2023-02-02,2023-02-22,2,20
46931.0,367012,1,1,1,0,2023-02-02,2023-02-22,1,20
46931.0,369026,3,3,10,0,2023-02-02,2023-02-22,10,20
46931.0,373019,3,3,3,0,2023-02-02,2023-02-22,3,20
46931.0,378019,1,1,1,0,2023-02-02,2023-02-22,1,20
46931.0,6968020,1,1,1,0,2023-02-02,2023-02-22,1,20
46931.0,1AA0004,3,3,10,0,2023-02-02,2023-02-22,10,20
47157.0,5406,4,4,2,2,2023-01-29,2023-02-26,0,28
47171.0,1AB2807,1,1,1,1,2022-10-28,2022-11-04,0,7
47200.0,5482401,4,4,4,4,2023-01-30,2023-03-28,0,57
47200.0,6598405,9,9,4,4,2023-01-30,2023-03-23,0,52
47200.0,6623400,7,7,4,4,2023-01-30,2023-03-23,0,52
47289.0,5482401,6,6,6,6,2023-01-03,2023-02-09,0,37
47289.0,9511404,2,0,4,0,2023-01-03,2023-02-09,4,37
47330.0,5406,2,2,2,2,2023-02-09,2023-03-24,0,43
47330.0,16403,1,1,1,1,2023-02-09,2023-03-24,0,43
47330.0,5482401,4,4,2,2,2023-02-09,2023-03-24,0,43
47331.0,373019,1,0,1,0,2023-02-10,2023-03-13,1,31
47405.0,829012,4,4,4,4,2023-01-10,2023-02-14,0,35
47405.0,830019,4,4,4,4,2023-01-10,2023-02-14,0,35
47405.0,6979407,10,10,10,10,2022-12-27,2023-02-14,0,49
47483.0,5482401,5,5,2,2,2023-01-06,2023-02-09,0,34
47582.0,16403,4,4,4,4,2023-01-05,2023-01-10,0,5
47582.0,97403,4,4,4,0,2023-01-05,2023-01-10,4,5
47582.0,97403,4,4,4,4,2023-01-05,2023-01-10,0,5
47582.0,504010,2,0,2,0,2023-01-05,2023-01-10,2,5
47582.0,504010,2,2,2,0,2023-01-05,2023-01-17,2,12
47582.0,504010,2,2,2,0,2023-01-05,2023-02-21,2,47
47582.0,504010,2,2,2,0,2023-01-10,2023-01-17,2,7
47582.0,504010,2,2,2,0,2023-01-10,2023-02-21,2,42
47582.0,504010,6,6,2,0,2023-01-10,2023-03-10,2,59
47582.0,504010,2,2,2,2,2023-01-17,2023-02-21,0,35
47582.0,504010,6,6,2,2,2023-01-17,2023-03-10,0,52
47582.0,504010,6,6,2,2,2023-02-21,2023-03-10,0,17
47582.0,505018,2,0,2,0,2023-01-05,2023-01-10,2,5
47582.0,505018,2,2,2,0,2023-01-05,2023-01-17,2,12
47582.0,505018,2,2,2,0,2023-01-05,2023-02-21,2,47
47582.0,505018,2,2,2,0,2023-01-10,2023-01-17,2,7
47582.0,505018,2,2,2,0,2023-01-10,2023-02-21,2,42
47582.0,505018,6,6,2,0,2023-01-10,2023-03-10,2,59
47582.0,505018,2,2,2,2,2023-01-17,2023-02-21,0,35
47582.0,505018,6,6,2,2,2023-01-17,2023-03-10,0,52
47582.0,505018,6,6,2,2,2023-02-21,2023-03-10,0,17
47582.0,546012,1,1,1,1,2023-01-05,2023-01-10,0,5
47582.0,547010,1,1,1,1,2023-01-05,2023-01-10,0,5
47582.0,548026,1,1,1,1,2023-01-05,2023-01-10,0,5
47582.0,549024,1,1,1,1,2023-01-05,2023-01-10,0,5
47582.0,571019,1,1,1,1,2023-02-21,2023-03-10,0,17
47582.0,1412402,5,5,5,5,2023-01-05,2023-01-10,0,5
47582.0,5482401,4,4,4,4,2023-01-05,2023-01-10,0,5
47582.0,5482401,4,4,4,4,2023-01-05,2023-02-21,0,47
47582.0,5482401,4,4,4,4,2023-01-10,2023-02-21,0,42
47582.0,5482401,6,6,4,4,2023-01-10,2023-03-10,0,59
47582.0,5482401,6,6,4,4,2023-02-21,2023-03-10,0,17
47613.0,571415,1,1,1,0,2023-03-06,2023-03-28,1,22
47650.0,5406,4,0,4,4,2023-01-04,2023-02-08,0,35
47650.0,97403,16,16,4,4,2023-01-04,2023-02-11,0,38
47650.0,97403,6,0,4,4,2023-01-04,2023-02-08,0,35
47650.0,97403,16,16,6,0,2023-02-08,2023-02-11,6,3
47650.0,367012,3,0,3,3,2023-01-04,2023-02-08,0,35
47650.0,367012,2,2,3,0,2023-02-08,2023-02-11,3,3
47650.0,4520400,1,1,1,1,2023-01-04,2023-02-08,0,35
47650.0,6598405,2,2,2,2,2023-01-04,2023-02-08,0,35
47650.0,9511404,2,2,1,1,2023-01-04,2023-02-08,0,35
47669.0,829012,2,0,2,2,2023-01-18,2023-03-15,0,56
47759.0,4757409,5,5,5,5,2022-12-28,2023-02-22,0,56
47779.0,91488,8,8,5,5,2022-12-29,2023-02-14,0,47
47779.0,367012,2,2,2,2,2022-12-29,2023-02-16,0,49
47779.0,367012,2,0,2,2,2022-12-29,2023-02-14,0,47
47779.0,367012,2,2,2,0,2023-02-14,2023-02-16,2,2
47779.0,1679408,1,0,1,1,2022-12-29,2023-02-16,0,49
47779.0,1679408,6,6,1,1,2022-12-29,2023-02-14,0,47
47779.0,3704138,10,10,8,8,2022-12-29,2023-02-14,0,47
47779.0,4907400,4,4,8,0,2022-12-29,2023-02-14,8,47
47779.0,5488409,8,0,6,6,2022-12-29,2023-02-16,0,49
47779.0,5488409,8,0,6,6,2022-12-29,2023-02-14,0,47
47779.0,5488409,8,0,8,0,2023-02-14,2023-02-16,8,2
47810.0,97403,7,7,10,0,2023-01-25,2023-02-26,10,32
47810.0,129503,1,0,1,0,2023-01-25,2023-02-26,1,32
47810.0,367012,5,5,5,0,2023-01-25,2023-02-26,5,32
47810.0,783010,2,0,1,0,2023-01-25,2023-02-26,1,32
47810.0,787012,2,0,1,0,2023-01-25,2023-02-26,1,32
47810.0,829012,1,1,2,0,2023-01-25,2023-02-26,2,32
47810.0,829012,2,0,2,0,2023-01-25,2023-02-26,2,32
47810.0,829012,1,1,2,0,2023-01-25,2023-02-26,2,32
47810.0,829012,2,0,2,0,2023-01-25,2023-02-26,2,32
47810.0,5482401,5,5,8,0,2023-01-25,2023-02-26,8,32
47810.0,6598405,5,5,8,0,2023-01-25,2023-02-26,8,32
47810.0,6623400,5,5,8,0,2023-01-25,2023-02-26,8,32
47810.0,1AB2733,5,0,5,0,2023-01-25,2023-02-26,5,32
47810.0,1AB2733,5,0,4,4,2023-01-25,2023-02-26,0,32
47810.0,1AB2735,4,0,6,0,2023-01-25,2023-02-26,6,32
47810.0,1AB2739,3,0,1,0,2023-01-25,2023-02-26,1,32
47823.0,5480405,1,1,1,1,2023-02-10,2023-02-21,0,11
47912.0,630054,2,0,2,0,2022-12-29,2023-01-03,2,5
47912.0,630054,2,0,2,2,2022-12-29,2023-01-03,0,5
47992.0,14407,2,2,2,2,2023-01-19,2023-03-14,0,54
47992.0,97403,2,2,2,2,2023-01-19,2023-03-14,0,54
47992.0,5482401,5,5,2,2,2023-01-19,2023-03-14,0,54
48041.0,504010,2,2,1,1,2023-01-11,2023-03-08,0,56
48041.0,505018,2,2,2,2,2023-01-11,2023-03-08,0,56
48054.0,1402403,16,16,16,16,2022-12-08,2023-02-01,0,55
48054.0,5148409,11,11,5,5,2022-12-08,2023-02-01,0,55
48054.0,5482401,10,10,6,6,2022-12-08,2023-02-01,0,55
48054.0,6923016,8,8,6,6,2022-12-08,2023-02-01,0,55
48137.0,97403,8,8,8,8,2023-02-13,2023-03-06,0,21
48248.0,504010,3,3,3,3,2023-01-04,2023-02-20,0,47
48248.0,505018,5,5,5,5,2023-01-04,2023-02-20,0,47
48263.0,1402403,3,3,3,0,2023-01-03,2023-01-06,3,3
48333.0,8720790,4,4,6,0,2023-01-16,2023-02-16,6,31
48355.0,6979407,1,1,1,0,2023-01-25,2023-02-09,1,15
48363.0,505018,4,4,4,4,2023-02-27,2023-03-02,0,3
48370.0,1AB2733,3,3,1,1,2023-02-09,2023-02-15,0,6
48370.0,1AB2735,5,5,1,1,2023-02-09,2023-02-15,0,6
48525.0,14407,2,2,2,0,2022-12-27,2023-02-08,2,43
48525.0,14407,3,3,2,2,2023-02-08,2023-03-15,0,35
48554.0,829012,2,2,1,1,2023-01-12,2023-01-18,0,6
48560.0,91488,4,4,3,0,2023-01-31,2023-03-15,3,43
48560.0,97403,6,6,4,0,2023-02-05,2023-03-15,4,38
48560.0,367012,1,1,3,0,2023-01-31,2023-03-15,3,43
48560.0,5482401,2,2,3,0,2023-02-05,2023-03-15,3,38
48560.0,8720790,2,2,3,0,2023-02-05,2023-03-15,3,38
48575.0,5482401,6,6,6,6,2022-11-10,2023-01-03,0,54
48660.0,91488,24,24,15,15,2023-01-19,2023-03-02,0,42
48660.0,97403,24,24,15,15,2023-01-19,2023-03-02,0,42
48660.0,1402403,27,27,15,15,2023-01-19,2023-03-02,0,42
48660.0,4608404,12,12,6,6,2023-01-19,2023-03-02,0,42
48695.0,91488,8,8,8,8,2023-01-10,2023-01-20,0,10
48695.0,5482401,14,14,8,8,2023-01-10,2023-01-20,0,10
48732.0,364034,1,1,1,1,2023-01-04,2023-01-23,0,19
48790.0,8720790,2,2,3,0,2023-01-13,2023-01-19,3,6
48801.0,25628,10,10,10,10,2022-12-16,2023-01-25,0,40
48801.0,25628,10,10,5,5,2022-12-12,2022-12-16,0,4
48801.0,25628,7,7,5,5,2022-12-12,2023-02-07,0,57
48801.0,25628,7,7,5,5,2022-12-12,2023-02-07,0,57
48801.0,25628,10,10,5,5,2022-12-12,2023-01-25,0,44
48801.0,25628,7,7,7,7,2023-02-07,2023-03-15,0,36
48801.0,25628,7,7,7,7,2023-02-07,2023-03-15,0,36
48801.0,6345400,8,8,8,8,2023-02-27,2023-02-28,0,1
48801.0,6345400,8,8,8,8,2023-01-04,2023-02-28,0,55
48801.0,6345400,8,8,8,8,2023-01-04,2023-02-27,0,54
48829.0,97403,4,4,4,0,2023-03-05,2023-03-16,4,11
48829.0,367012,2,2,2,0,2023-03-05,2023-03-16,2,11
48829.0,2101012,2,2,1,1,2023-03-01,2023-03-13,0,12
48829.0,2101020,2,2,1,1,2023-03-01,2023-03-13,0,12
48829.0,2101046,2,2,1,1,2023-03-01,2023-03-13,0,12
48829.0,6968020,1,1,1,0,2023-03-05,2023-03-16,1,11
48829.0,6968038,1,1,1,0,2023-03-05,2023-03-16,1,11
48829.0,8720790,2,2,1,1,2023-03-10,2023-03-16,0,6
48929.0,5406,1,1,1,0,2023-01-30,2023-02-17,1,18
48929.0,394106,1,0,1,0,2023-01-30,2023-02-17,1,18
48929.0,4520400,2,2,2,0,2023-01-30,2023-02-17,2,18
48929.0,5985405,2,2,1,1,2023-01-30,2023-02-17,0,18
48950.0,505018,5,5,5,0,2023-01-16,2023-01-30,5,14
48972.0,9875016,5,5,1,1,2023-01-04,2023-02-20,0,47
48972.0,9892010,5,5,3,3,2023-01-04,2023-02-20,0,47
48979.0,97403,4,4,2,2,2023-01-16,2023-03-09,0,52
48980.0,5406,2,2,2,0,2023-01-19,2023-03-06,2,46
48980.0,97403,2,2,2,0,2023-01-19,2023-03-06,2,46
48980.0,8740012,8,8,8,0,2023-01-19,2023-03-06,8,46
48996.0,233023,1,1,1,0,2022-12-26,2023-02-01,1,37
49000.0,504010,2,2,2,2,2023-01-11,2023-01-25,0,14
49000.0,504010,2,2,2,2,2023-01-25,2023-03-16,0,50
49000.0,505018,2,2,2,2,2023-01-11,2023-01-25,0,14
49000.0,505018,5,5,2,2,2023-01-25,2023-03-16,0,50
49004.0,1412402,4,4,4,0,2023-01-09,2023-01-10,4,1
49010.0,5482401,4,4,1,1,2022-12-18,2023-02-02,0,46
49010.0,5482401,3,3,1,1,2022-12-18,2023-02-06,0,50
49019.0,374025,2,2,1,1,2023-01-10,2023-01-26,0,16
49019.0,505018,5,5,7,0,2023-01-10,2023-01-25,7,15
49019.0,505018,2,2,7,0,2023-01-10,2023-02-13,7,34
49019.0,505018,5,5,7,0,2023-01-10,2023-01-25,7,15
49019.0,505018,2,2,7,0,2023-01-10,2023-02-13,7,34
49019.0,560012,4,0,4,0,2023-01-10,2023-01-25,4,15
49019.0,560012,1,0,4,0,2023-01-10,2023-02-13,4,34
49019.0,560012,1,1,4,0,2023-01-10,2023-02-24,4,45
49019.0,560012,1,0,4,0,2023-01-25,2023-02-13,4,19
49019.0,560012,1,1,4,0,2023-01-25,2023-02-24,4,30
49019.0,560012,1,1,1,0,2023-02-13,2023-02-24,1,11
49019.0,631078,6,0,6,0,2023-01-10,2023-01-25,6,15
49019.0,632035,6,6,6,0,2023-01-10,2023-01-25,6,15
49072.0,505018,6,6,4,4,2023-01-30,2023-02-05,0,6
49073.0,505018,2,2,2,0,2023-01-17,2023-02-22,2,36
49088.0,4520400,2,2,2,2,2023-02-02,2023-03-27,0,53
49095.0,505018,4,4,4,0,2022-12-29,2023-01-24,4,26
49135.0,505018,2,2,2,0,2023-01-06,2023-01-26,2,20
49170.0,5406,3,3,2,0,2022-12-02,2023-01-20,2,49
49170.0,5406,3,3,2,2,2022-12-02,2023-01-20,0,49
49170.0,5406,3,3,3,3,2023-01-20,2023-03-19,0,58
49170.0,97403,2,2,2,2,2023-01-20,2023-03-19,0,58
49170.0,8717714,1,1,1,1,2023-01-20,2023-03-19,0,58
49177.0,62349,3,3,2,2,2022-12-27,2023-02-16,0,51
49177.0,6625331,5,5,2,2,2022-12-27,2023-02-16,0,51
49178.0,1551408,4,4,4,0,2023-01-19,2023-03-01,4,41
49256.0,504010,3,0,2,0,2023-01-16,2023-03-06,2,49
49256.0,504010,3,3,2,0,2023-01-16,2023-03-07,2,50
49256.0,504010,3,3,3,0,2023-03-06,2023-03-07,3,1
49256.0,505018,5,0,2,0,2023-01-16,2023-03-06,2,49
49256.0,505018,5,5,2,0,2023-01-16,2023-03-07,2,50
49256.0,505018,5,5,5,0,2023-03-06,2023-03-07,5,1
49256.0,829012,4,4,1,1,2023-01-16,2023-03-07,0,50
49256.0,6598405,2,2,2,2,2023-01-16,2023-03-06,0,49
49324.0,2101012,1,1,1,1,2023-01-23,2023-02-24,0,32
49324.0,2101020,1,0,1,0,2023-01-23,2023-02-24,1,32
49324.0,2101046,1,0,1,0,2023-01-23,2023-02-24,1,32
49324.0,2101053,1,1,1,1,2023-01-23,2023-02-24,0,32
49403.0,51409,2,2,2,0,2023-01-24,2023-02-22,2,29
49403.0,57407,3,3,3,0,2023-01-24,2023-02-22,3,29
49403.0,9511404,2,2,2,0,2023-01-24,2023-02-22,2,29
49403.0,1AB2919,9,9,9,0,2023-01-24,2023-02-22,9,29
49449.0,5406,5,5,5,0,2023-02-16,2023-03-26,5,38
49449.0,504010,3,3,3,0,2023-02-16,2023-03-26,3,38
49449.0,505018,6,6,6,0,2023-02-16,2023-03-26,6,38
49469.0,24406,30,30,20,20,2023-02-15,2023-03-02,0,15
49469.0,5148409,34,34,20,20,2023-02-15,2023-03-02,0,15
49469.0,5148409,20,20,20,20,2023-01-19,2023-02-15,0,27
49469.0,5148409,34,34,20,20,2023-01-19,2023-03-02,0,42
49485.0,505018,5,5,5,0,2023-01-23,2023-02-02,5,10
49485.0,1402403,16,16,12,12,2023-03-07,2023-03-10,0,3
49485.0,1AA8985,1,1,1,0,2023-03-07,2023-03-09,1,2
49534.0,5148409,20,20,10,10,2023-02-01,2023-03-02,0,29
49562.0,5482401,4,4,3,3,2022-10-24,2022-12-15,0,52
49602.0,1AB6168,1,1,1,0,2023-01-27,2023-03-08,1,40
49605.0,5406,3,3,3,0,2023-02-06,2023-03-22,3,44
49605.0,1105403,3,3,8,0,2023-02-06,2023-03-22,8,44
49605.0,1AB2919,4,4,4,0,2023-02-06,2023-03-22,4,44
49608.0,504010,3,3,1,0,2023-01-03,2023-02-01,1,29
49644.0,5406,6,0,3,0,2023-03-08,2023-03-28,3,20
49644.0,97403,5,0,5,5,2023-01-10,2023-03-08,0,57
49644.0,97403,10,0,5,0,2023-03-08,2023-03-28,5,20
49644.0,6598405,8,8,8,8,2023-03-08,2023-03-28,0,20
49692.0,365016,1,1,1,1,2023-01-23,2023-03-08,0,44
49692.0,365016,1,1,1,0,2023-01-23,2023-03-08,1,44
49692.0,367012,1,1,1,1,2023-01-23,2023-03-08,0,44
49692.0,369026,1,1,1,1,2023-01-23,2023-03-08,0,44
49692.0,369026,1,1,1,0,2023-01-23,2023-03-08,1,44
49692.0,1AA0004,1,1,1,1,2023-01-23,2023-03-08,0,44
49702.0,1402403,36,36,6,6,2023-01-05,2023-01-25,0,20
49711.0,34405,2,2,2,2,2023-01-31,2023-03-01,0,29
49711.0,97403,4,4,4,4,2022-12-23,2023-01-31,0,39
49711.0,97403,4,4,4,4,2023-01-31,2023-03-01,0,29
49711.0,1679408,4,0,3,0,2022-12-23,2023-01-31,3,39
49711.0,1679408,4,4,3,0,2022-12-23,2023-01-31,3,39
49711.0,1679408,5,5,4,0,2023-01-31,2023-03-01,4,29
49711.0,1679408,5,5,4,4,2023-01-31,2023-03-01,0,29
49711.0,4520400,1,1,1,1,2023-01-31,2023-03-01,0,29
49711.0,4608404,2,2,1,1,2023-01-31,2023-03-30,0,58
49711.0,4608404,1,1,1,1,2023-01-31,2023-03-01,0,29
49711.0,4608404,2,2,1,1,2023-03-01,2023-03-30,0,29
49711.0,4907400,14,14,5,5,2022-12-23,2023-01-13,0,21
49711.0,4907400,7,7,5,5,2022-12-23,2023-01-31,0,39
49711.0,5482401,7,7,7,7,2022-12-23,2023-01-13,0,21
49711.0,5482401,7,7,7,7,2023-01-13,2023-03-01,0,47
49711.0,5482401,8,8,6,6,2023-01-31,2023-03-30,0,58
49711.0,5482401,7,7,6,6,2023-01-31,2023-03-01,0,29
49711.0,5482401,8,8,7,7,2023-03-01,2023-03-30,0,29
49711.0,6179403,2,2,2,2,2023-01-31,2023-03-30,0,58
49711.0,6179403,2,2,2,2,2023-01-31,2023-03-01,0,29
49711.0,6179403,2,2,2,2,2023-03-01,2023-03-30,0,29
49711.0,6598405,7,7,5,5,2022-12-23,2023-01-13,0,21
49711.0,6598405,3,3,3,3,2023-01-31,2023-03-30,0,58
49880.0,14407,2,2,2,2,2023-02-03,2023-03-21,0,46
49880.0,91488,2,2,1,1,2023-02-03,2023-03-21,0,46
49880.0,367012,1,1,2,0,2023-02-16,2023-03-21,2,33
49880.0,5482401,4,4,3,3,2023-02-03,2023-03-21,0,46
49955.0,1412402,4,4,4,4,2023-02-20,2023-03-16,0,24
50101.0,309170,1,1,1,0,2023-02-10,2023-03-23,1,41
50101.0,1105403,8,8,4,4,2023-02-10,2023-03-23,0,41
50107.0,56409,10,10,3,3,2022-12-21,2023-02-09,0,50
50136.0,394106,5,0,5,0,2023-01-17,2023-02-07,5,21
50136.0,504010,2,2,1,1,2023-01-17,2023-02-07,0,21
50136.0,505018,2,2,2,2,2023-01-17,2023-02-07,0,21
50136.0,725012,4,4,1,1,2023-01-17,2023-02-07,0,21
50155.0,571019,2,2,2,2,2023-01-03,2023-02-23,0,51
50156.0,9809015,2,2,2,2,2023-01-24,2023-02-22,0,29
50178.0,48398,5,0,5,0,2023-01-27,2023-03-09,5,41
50178.0,48406,4,4,4,4,2023-01-27,2023-03-09,0,41
50198.0,5482401,8,8,6,6,2023-01-04,2023-02-23,0,50
50200.0,6625331,2,2,2,0,2023-01-30,2023-02-02,2,3
50268.0,505018,3,3,5,0,2023-01-23,2023-02-06,5,14
50303.0,5482401,8,8,8,8,2022-12-12,2023-01-05,0,24
50393.0,5482401,7,0,4,4,2023-01-31,2023-03-24,0,52
50492.0,504010,4,4,2,2,2023-02-13,2023-03-15,0,30
50492.0,505018,4,4,2,2,2023-02-13,2023-03-15,0,30
50501.0,1105403,10,10,10,10,2023-02-08,2023-03-02,0,22
50572.0,5406,4,4,3,3,2022-12-09,2023-01-10,0,32
50572.0,5483409,3,3,2,2,2022-12-09,2023-01-10,0,32
50642.0,14407,4,4,3,3,2023-01-03,2023-02-13,0,41
50642.0,367012,1,1,1,1,2023-01-03,2023-02-13,0,41
50642.0,369018,1,1,1,0,2023-01-03,2023-02-13,1,41
50676.0,6598405,3,3,2,2,2023-01-18,2023-02-06,0,19
50700.0,97403,8,8,2,2,2023-01-09,2023-03-08,0,58
50700.0,5482401,4,4,2,2,2023-01-09,2023-03-08,0,58
50700.0,8720790,2,2,3,0,2023-01-09,2023-03-08,3,58
50715.0,378019,1,1,1,1,2023-01-18,2023-02-07,0,20
50806.0,504010,1,1,1,0,2023-02-01,2023-03-20,1,47
50806.0,505018,2,2,2,0,2023-02-01,2023-03-20,2,47
50907.0,14407,2,2,2,2,2022-12-30,2023-02-21,0,53
50907.0,97403,2,2,2,2,2022-12-30,2023-02-21,0,53
50914.0,670993,25,25,12,12,2023-01-11,2023-01-19,0,8
50914.0,6979407,6,6,5,5,2023-01-13,2023-03-07,0,53
50914.0,1AA9096,25,25,12,12,2023-01-11,2023-01-19,0,8
50974.0,82404,2,2,1,1,2023-02-15,2023-03-02,0,15
51011.0,1AA9699,4,4,4,0,2022-12-14,2023-02-09,4,57
51024.0,6979407,6,6,2,2,2023-01-26,2023-02-15,0,20
51024.0,6979407,2,2,2,2,2023-01-26,2023-02-07,0,12
51024.0,6979407,4,0,2,2,2023-01-26,2023-02-27,0,32
51024.0,6979407,6,6,2,2,2023-02-07,2023-02-15,0,8
51024.0,6979407,4,0,2,2,2023-02-07,2023-02-27,0,20
51025.0,6979407,2,2,2,2,2023-01-13,2023-02-24,0,42
51042.0,387036,1,1,1,1,2023-02-09,2023-03-02,0,21
51042.0,388018,1,1,1,0,2023-02-09,2023-03-02,1,21
51048.0,1AB3456,4,4,4,0,2023-01-23,2023-02-06,4,14
51130.0,8720790,2,2,2,0,2023-01-11,2023-02-01,2,21
51143.0,1401405,6,6,6,0,2022-12-28,2023-01-09,6,12
51167.0,367012,2,2,2,2,2023-02-23,2023-03-22,0,27
51167.0,4907400,20,20,18,18,2023-01-12,2023-01-27,0,15
51167.0,4907400,18,18,18,0,2023-01-09,2023-01-12,18,3
51167.0,4907400,20,20,18,0,2023-01-09,2023-01-27,18,18
51167.0,5482401,19,19,4,4,2023-01-09,2023-02-23,0,45
51167.0,5482401,20,20,4,4,2023-01-09,2023-01-27,0,18
51167.0,6623400,4,4,4,4,2023-02-23,2023-03-22,0,27
51250.0,5406,2,2,2,2,2023-01-16,2023-02-09,0,24
51250.0,91488,1,1,1,1,2023-01-16,2023-02-09,0,24
51250.0,582016,2,0,1,1,2023-01-16,2023-02-09,0,24
51250.0,8720790,3,3,3,0,2023-01-16,2023-02-09,3,24
51311.0,504010,2,2,2,0,2023-02-03,2023-02-28,2,25
51311.0,505018,4,4,4,0,2023-02-03,2023-02-28,4,25
51333.0,24406,1,1,1,0,2023-01-11,2023-03-10,1,58
51333.0,62349,2,2,2,0,2023-01-11,2023-03-10,2,58
51333.0,91488,6,6,6,0,2023-01-11,2023-03-10,6,58
51333.0,4520400,1,1,1,0,2023-01-11,2023-03-10,1,58
51334.0,51409,2,2,1,1,2023-01-11,2023-02-27,0,47
51334.0,8720790,1,1,1,0,2023-01-11,2023-02-27,1,47
51334.0,1AB2919,4,4,16,0,2023-01-11,2023-02-27,16,47
51357.0,505018,8,8,8,0,2022-12-28,2023-02-08,8,42
51357.0,5482401,16,16,10,10,2022-12-28,2023-02-08,0,42
51395.0,4757409,4,0,16,0,2023-03-02,2023-03-20,16,18
51556.0,45626,2,2,1,1,2023-02-08,2023-03-07,0,27
51556.0,1AB2919,9,9,2,2,2023-02-08,2023-03-07,0,27
51631.0,373019,2,2,2,0,2023-02-01,2023-03-09,2,36
51631.0,374025,2,2,2,0,2023-02-01,2023-03-09,2,36
51631.0,8720790,2,2,2,0,2023-02-01,2023-03-09,2,36
51631.0,1AA0004,2,2,2,0,2023-02-01,2023-03-09,2,36
51729.0,9511404,3,3,2,2,2023-01-10,2023-02-10,0,31
51732.0,504010,3,3,3,3,2023-01-03,2023-02-23,0,51
51732.0,504010,3,3,2,2,2023-02-05,2023-02-23,0,18
51732.0,505018,3,3,3,3,2023-02-05,2023-02-23,0,18
51761.0,505018,2,2,2,0,2023-01-04,2023-01-13,2,9
51761.0,505018,4,4,2,2,2023-01-13,2023-03-14,0,60
51763.0,367012,2,2,1,1,2023-01-23,2023-03-23,0,59
51763.0,373019,2,2,1,1,2023-01-23,2023-03-23,0,59
51763.0,374025,2,2,1,1,2023-01-23,2023-03-23,0,59
51763.0,5482401,8,8,6,6,2023-01-23,2023-03-23,0,59
51763.0,8720790,2,2,2,2,2023-01-23,2023-03-23,0,59
51924.0,505018,5,5,2,2,2023-02-03,2023-03-08,0,33
51928.0,504010,1,1,1,1,2023-02-17,2023-03-02,0,13
51928.0,504010,1,1,1,1,2023-02-17,2023-03-07,0,18
51928.0,504010,1,1,1,1,2023-03-02,2023-03-07,0,5
51928.0,505018,1,1,1,1,2023-02-17,2023-03-02,0,13
51928.0,505018,1,1,1,1,2023-02-17,2023-03-07,0,18
51928.0,505018,1,1,1,1,2023-03-02,2023-03-07,0,5
51928.0,725012,1,1,1,1,2023-02-17,2023-03-02,0,13
51928.0,725012,1,1,1,1,2023-02-17,2023-03-07,0,18
51928.0,725012,1,1,1,1,2023-03-02,2023-03-07,0,5
51928.0,4520400,2,2,2,2,2023-02-17,2023-03-02,0,13
51928.0,4520400,2,2,2,2,2023-02-17,2023-03-07,0,18
51928.0,4520400,2,2,2,2,2023-03-02,2023-03-07,0,5
51928.0,5482401,5,5,5,5,2023-02-17,2023-03-02,0,13
51928.0,5482401,5,5,5,5,2023-02-17,2023-03-07,0,18
51928.0,5482401,5,5,5,5,2023-03-02,2023-03-07,0,5
51979.0,91488,10,10,8,8,2023-01-16,2023-03-09,0,52
51979.0,4907400,20,20,11,11,2023-01-24,2023-03-25,0,60
51979.0,6598405,10,10,10,10,2023-01-24,2023-03-25,0,60
51979.0,6598405,10,10,10,10,2023-01-09,2023-01-24,0,15
52046.0,97403,40,40,20,20,2023-02-15,2023-03-21,0,34
52140.0,14407,4,4,4,0,2023-02-26,2023-03-02,4,4
52140.0,24406,3,3,3,0,2023-02-26,2023-03-02,3,4
52140.0,97403,2,2,2,0,2023-02-26,2023-03-02,2,4
52140.0,367012,2,0,2,2,2023-02-26,2023-03-02,0,4
52140.0,374025,1,1,1,0,2023-02-26,2023-03-02,1,4
52140.0,829012,1,0,1,1,2023-02-26,2023-03-02,0,4
52140.0,5482401,2,2,2,0,2023-02-26,2023-03-02,2,4
52155.0,504010,3,0,1,1,2023-02-06,2023-03-03,0,25
52155.0,505018,5,5,3,3,2023-02-06,2023-03-03,0,25
52155.0,570094,1,1,1,1,2023-02-06,2023-03-03,0,25
52211.0,8740012,10,10,10,0,2023-01-16,2023-02-17,10,32
52220.0,364026,3,3,3,0,2023-01-03,2023-01-25,3,22
52220.0,5482401,12,12,1,1,2023-01-03,2023-01-25,0,22
52220.0,8740012,3,3,3,0,2023-01-03,2023-01-25,3,22
52223.0,365016,1,1,1,1,2023-02-03,2023-03-08,0,33
52223.0,504010,1,1,1,1,2023-02-03,2023-03-20,0,45
52223.0,505018,4,4,4,4,2023-02-03,2023-03-20,0,45
52223.0,6968020,1,1,1,0,2023-02-03,2023-03-08,1,33
52223.0,1AB3449,1,0,1,0,2023-02-03,2023-03-20,1,45
52223.0,1AB3449,1,0,1,1,2023-02-03,2023-03-20,0,45
52237.0,829012,2,2,1,0,2023-02-07,2023-02-13,1,6
52237.0,1AB1973,1,1,1,1,2023-02-07,2023-02-14,0,7
52237.0,1AB2190,4,4,5,0,2023-02-07,2023-02-14,5,7
52261.0,505018,4,4,4,0,2023-01-12,2023-02-08,4,27
52287.0,1402403,10,10,8,8,2023-02-10,2023-03-22,0,40
52291.0,504010,2,2,2,0,2023-01-03,2023-01-25,2,22
52299.0,24406,3,3,2,2,2023-01-04,2023-02-03,0,30
52299.0,51409,2,0,1,0,2023-01-04,2023-02-06,1,33
52299.0,62349,2,2,1,1,2023-01-04,2023-02-06,0,33
52299.0,4520400,1,1,1,1,2023-01-04,2023-02-03,0,30
52299.0,4608404,2,2,2,0,2023-01-04,2023-02-06,2,33
52299.0,5482401,4,4,5,0,2023-01-04,2023-02-06,5,33
52299.0,5482401,8,0,5,0,2023-01-04,2023-02-03,5,30
52299.0,5482401,4,4,8,0,2023-02-03,2023-02-06,8,3
52299.0,8720790,4,4,5,0,2023-01-04,2023-02-06,5,33
52299.0,8720790,3,0,5,0,2023-01-04,2023-02-03,5,30
52299.0,8720790,4,4,3,0,2023-02-03,2023-02-06,3,3
52299.0,1AA9702,1,0,1,1,2023-01-10,2023-02-03,0,24
52299.0,1AB2919,4,4,3,3,2023-01-04,2023-02-06,0,33
52299.0,1AB2919,10,10,3,3,2023-01-04,2023-02-03,0,30
52317.0,504010,3,3,2,2,2022-12-29,2023-01-06,0,8
52317.0,505018,6,6,4,4,2022-12-29,2023-01-06,0,8
52325.0,82404,2,2,2,2,2023-02-28,2023-03-03,0,3
52351.0,5482401,16,0,1,0,2023-01-10,2023-02-27,1,48
52351.0,5482401,16,0,4,4,2023-01-10,2023-02-27,0,48
52500.0,1412402,4,4,4,4,2022-12-23,2023-01-25,0,33
52576.0,571019,2,2,1,1,2023-01-09,2023-02-01,0,23
52680.0,5482401,8,8,8,8,2023-01-17,2023-03-14,0,56
52733.0,1402403,2,2,2,2,2023-01-09,2023-02-21,0,43
52733.0,4757409,7,7,1,1,2023-01-09,2023-02-21,0,43
52733.0,5482401,5,0,1,1,2023-01-09,2023-02-21,0,43
52733.0,5482401,5,5,1,1,2023-01-09,2023-02-21,0,43
52793.0,14407,4,4,4,4,2023-01-12,2023-02-23,0,42
52804.0,504010,1,1,1,1,2022-12-27,2023-02-19,0,54
52804.0,505018,3,3,3,3,2022-12-27,2023-02-19,0,54
52814.0,89400,8,8,4,4,2023-02-06,2023-03-06,0,28
52814.0,97403,25,25,8,8,2022-12-19,2023-01-10,0,22
52814.0,97403,17,17,8,8,2022-12-19,2023-02-06,0,49
52814.0,367012,4,4,2,2,2022-12-19,2023-01-10,0,22
52814.0,4064408,1,1,1,1,2023-01-10,2023-03-06,0,55
52832.0,369018,1,1,1,0,2022-12-15,2023-01-03,1,19
52880.0,14407,8,8,2,2,2023-02-07,2023-03-17,0,38
52880.0,5482401,6,6,2,2,2023-02-07,2023-03-17,0,38
52884.0,504010,4,4,3,3,2023-01-17,2023-02-07,0,21
52884.0,504010,3,3,3,3,2023-01-17,2023-02-24,0,38
52884.0,504010,6,6,4,4,2023-02-07,2023-03-29,0,50
52884.0,504010,6,6,1,1,2023-02-24,2023-03-29,0,33
52884.0,504010,6,6,3,3,2023-02-24,2023-03-29,0,33
52884.0,505018,7,7,4,4,2023-01-17,2023-02-07,0,21
52884.0,505018,6,6,4,4,2023-01-17,2023-02-24,0,38
52884.0,505018,12,12,7,7,2023-02-07,2023-03-29,0,50
52884.0,505018,12,12,2,2,2023-02-24,2023-03-29,0,33
52884.0,505018,12,12,6,6,2023-02-24,2023-03-29,0,33
52884.0,829012,1,1,1,0,2023-02-07,2023-02-24,1,17
52884.0,829012,2,2,1,0,2023-02-07,2023-03-29,1,50
52884.0,829012,2,2,1,1,2023-02-24,2023-03-29,0,33
52928.0,91488,3,3,2,2,2023-02-23,2023-02-27,0,4
52928.0,1AB1973,1,1,1,0,2023-02-23,2023-02-27,1,4
52978.0,3029395,10,10,6,6,2023-03-02,2023-03-07,0,5
52978.0,4520400,2,2,2,2,2022-12-29,2023-01-23,0,25
52978.0,5985405,6,6,6,6,2023-03-02,2023-03-07,0,5
52978.0,6979407,4,0,4,4,2023-01-10,2023-03-02,0,51
53052.0,4520400,6,6,6,6,2023-02-15,2023-02-22,0,7
53052.0,5480405,6,6,4,4,2023-02-15,2023-02-22,0,7
53052.0,5480405,4,4,4,4,2023-02-15,2023-02-28,0,13
53052.0,5482401,8,8,8,8,2023-02-15,2023-02-22,0,7
53052.0,1AA0004,2,2,2,2,2023-01-04,2023-02-15,0,42
53053.0,5482401,6,6,6,6,2023-02-27,2023-03-22,0,23
53068.0,97403,8,8,7,7,2023-01-26,2023-03-03,0,36
53075.0,5482401,8,8,8,8,2023-03-03,2023-03-22,0,19
53077.0,24406,2,2,2,2,2023-01-20,2023-02-15,0,26
53077.0,48406,2,2,1,1,2023-02-15,2023-03-15,0,28
53077.0,89400,4,4,4,4,2023-01-05,2023-01-20,0,15
53077.0,97403,6,6,2,2,2023-02-15,2023-03-02,0,15
53077.0,97403,2,2,2,2,2023-02-15,2023-03-15,0,28
53077.0,5482401,4,4,4,4,2023-01-05,2023-01-20,0,15
53077.0,5482401,6,6,4,4,2023-01-05,2023-02-15,0,41
53077.0,5482401,6,6,4,4,2023-01-20,2023-02-15,0,26
53077.0,5482401,8,8,4,4,2023-01-20,2023-03-15,0,54
53077.0,5482401,8,8,6,6,2023-02-15,2023-03-15,0,28
53078.0,367012,1,1,1,1,2023-02-06,2023-03-06,0,28
53078.0,5482401,10,10,5,5,2023-02-06,2023-03-06,0,28
53078.0,5482401,10,10,6,6,2023-01-05,2023-03-06,0,60
53078.0,1AB2691,2,2,1,1,2023-02-06,2023-03-06,0,28
53078.0,1AB2692,2,2,1,1,2023-02-06,2023-03-06,0,28
53078.0,1AB2692,2,2,2,2,2023-01-05,2023-03-06,0,60
53089.0,5406,3,3,2,2,2022-12-07,2023-01-31,0,55
53089.0,173070,1,1,1,0,2022-12-07,2023-01-12,1,36
53110.0,571019,1,1,1,1,2023-03-16,2023-03-27,0,11
53110.0,9511404,4,4,4,4,2023-02-02,2023-03-27,0,53
53146.0,8720790,4,4,4,0,2023-01-12,2023-01-25,4,13
53146.0,1AB2733,8,8,8,0,2023-01-12,2023-01-25,8,13
53149.0,6598405,2,2,2,2,2023-01-23,2023-02-03,0,11
53264.0,6979407,4,0,3,3,2023-02-28,2023-03-01,0,1
53264.0,6979407,3,3,4,0,2023-02-17,2023-02-28,4,11
53264.0,6979407,4,0,4,0,2023-02-17,2023-03-01,4,12
53286.0,3029395,2,2,12,0,2023-02-09,2023-03-29,12,48
53324.0,14407,2,2,2,0,2023-01-24,2023-02-06,2,13
53324.0,14407,1,1,2,0,2023-01-24,2023-02-16,2,23
53324.0,630062,2,2,1,1,2023-01-24,2023-02-16,0,23
53336.0,8720790,5,0,2,0,2023-02-08,2023-02-09,2,1
53361.0,97403,5,5,16,0,2022-12-19,2023-01-23,16,35
53361.0,97403,8,8,16,0,2022-12-19,2023-01-30,16,42
53361.0,97403,8,8,5,5,2023-01-23,2023-01-30,0,7
53361.0,373019,1,1,1,0,2022-12-19,2023-02-08,1,51
53361.0,8720790,4,4,4,0,2023-01-23,2023-02-14,4,22
53428.0,233023,5,5,5,5,2023-01-24,2023-02-15,0,22
53462.0,221010,2,2,2,0,2023-02-14,2023-02-17,2,3
53462.0,247016,2,2,2,0,2023-02-14,2023-02-17,2,3
53462.0,1AA9699,2,2,2,0,2023-02-14,2023-02-17,2,3
53575.0,372011,1,1,1,0,2023-02-17,2023-02-20,1,3
53577.0,97403,15,15,6,6,2023-01-19,2023-03-09,0,49
53668.0,5148409,6,6,6,6,2023-01-04,2023-02-02,0,29
53785.0,24406,2,2,2,0,2023-01-29,2023-03-14,2,44
53785.0,51409,1,1,1,0,2023-01-29,2023-03-14,1,44
53785.0,1240407,2,2,2,0,2023-01-29,2023-03-14,2,44
53785.0,5482401,4,4,4,0,2023-01-29,2023-03-14,4,44
53785.0,8720790,2,2,2,0,2023-01-29,2023-03-14,2,44
53785.0,9511404,1,1,1,0,2023-01-29,2023-03-14,1,44
53785.0,1AB4571,6,0,6,0,2023-01-29,2023-03-14,6,44
53787.0,14407,6,0,6,0,2023-01-26,2023-02-20,6,25
53787.0,14407,6,6,6,0,2023-01-26,2023-02-20,6,25
53862.0,14407,8,8,6,6,2023-02-10,2023-03-15,0,33
53884.0,504010,1,0,1,0,2023-01-04,2023-01-05,1,1
53884.0,505018,1,1,1,0,2023-01-04,2023-01-05,1,1
53928.0,6598405,5,5,1,1,2023-02-07,2023-03-20,0,41
53931.0,6598405,2,2,2,2,2023-01-12,2023-01-31,0,19
53933.0,372011,1,1,1,0,2022-12-27,2023-02-03,1,38
53933.0,504010,5,5,2,2,2023-01-25,2023-02-01,0,7
53933.0,505018,5,5,4,4,2023-01-25,2023-02-01,0,7
53936.0,97403,2,2,1,1,2023-01-26,2023-02-23,0,28
53936.0,97403,2,2,2,2,2023-01-03,2023-02-23,0,51
53936.0,504010,1,1,1,1,2023-01-23,2023-02-03,0,11
53936.0,504010,2,2,1,1,2023-01-23,2023-03-02,0,38
53936.0,504010,2,2,1,1,2023-02-03,2023-03-02,0,27
53936.0,505018,1,1,1,1,2023-01-23,2023-02-03,0,11
53936.0,505018,4,4,1,1,2023-01-23,2023-03-02,0,38
53936.0,505018,4,4,1,1,2023-02-03,2023-03-02,0,27
53936.0,5482401,4,4,2,2,2023-02-23,2023-02-27,0,4
53936.0,6623400,2,2,1,1,2023-01-26,2023-02-23,0,28
54033.0,97403,4,4,4,4,2023-02-01,2023-02-16,0,15
54033.0,1AB2733,4,4,4,4,2023-01-26,2023-02-16,0,21
54042.0,1AB2919,10,10,10,0,2022-12-27,2023-01-11,10,15
54106.0,4608404,3,3,2,2,2023-02-07,2023-03-02,0,23
54106.0,5482401,6,6,6,6,2023-02-07,2023-03-02,0,23
54107.0,41400,4,4,2,2,2023-01-10,2023-03-06,0,55
54107.0,45626,10,10,2,2,2023-01-10,2023-03-06,0,55
54107.0,97403,8,8,4,4,2023-01-10,2023-03-06,0,55
54119.0,24406,3,3,3,3,2022-12-27,2023-02-01,0,36
54119.0,24406,5,5,3,3,2023-02-01,2023-03-09,0,36
54135.0,24406,2,2,2,2,2023-01-03,2023-01-11,0,8
54135.0,24406,2,2,2,2,2023-01-03,2023-01-18,0,15
54135.0,24406,2,2,2,2,2023-01-11,2023-03-07,0,55
54135.0,24406,2,2,2,2,2023-01-11,2023-01-18,0,7
54135.0,24406,2,2,2,2,2023-01-18,2023-03-07,0,48
54135.0,34405,6,6,3,3,2023-02-23,2023-03-07,0,12
54135.0,34405,3,3,3,3,2023-01-03,2023-02-23,0,51
54135.0,34405,6,6,1,1,2023-01-11,2023-03-07,0,55
54135.0,34405,3,3,1,1,2023-01-11,2023-02-23,0,43
54135.0,2327022,1,1,1,1,2023-03-07,2023-03-20,0,13
54135.0,2327022,1,1,1,1,2023-03-07,2023-03-13,0,6
54135.0,2327022,1,1,1,1,2023-02-23,2023-03-20,0,25
54135.0,2327022,1,1,1,1,2023-02-23,2023-03-07,0,12
54135.0,2327022,1,1,1,1,2023-02-23,2023-03-13,0,18
54135.0,2327022,1,1,1,1,2023-03-13,2023-03-20,0,7
54135.0,2327022,1,1,1,1,2023-01-03,2023-02-23,0,51
54135.0,2327022,1,1,1,1,2023-01-03,2023-01-25,0,22
54135.0,2327022,1,0,1,1,2023-01-03,2023-01-18,0,15
54135.0,2327022,1,1,1,1,2023-01-25,2023-03-20,0,54
54135.0,2327022,1,1,1,1,2023-01-25,2023-03-07,0,41
54135.0,2327022,1,1,1,1,2023-01-25,2023-02-23,0,29
54135.0,2327022,1,1,1,1,2023-01-25,2023-03-13,0,47
54135.0,2327022,1,1,1,0,2023-01-18,2023-03-07,1,48
54135.0,2327022,1,1,1,0,2023-01-18,2023-02-23,1,36
54135.0,2327022,1,1,1,0,2023-01-18,2023-03-13,1,54
54135.0,2327022,1,1,1,0,2023-01-18,2023-01-25,1,7
54135.0,5482013,1000,1000,1000,1000,2023-03-07,2023-03-20,0,13
54135.0,5482013,1000,1000,1000,1000,2023-03-07,2023-03-13,0,6
54135.0,5482013,1000,1000,1000,1000,2023-02-23,2023-03-20,0,25
54135.0,5482013,1000,1000,1000,1000,2023-02-23,2023-03-07,0,12
54135.0,5482013,1000,1000,1000,1000,2023-02-23,2023-03-13,0,18
54135.0,5482013,1000,1000,1000,1000,2023-03-13,2023-03-20,0,7
54135.0,5482013,1000,1000,1000,1000,2023-01-03,2023-02-23,0,51
54135.0,5482013,1000,1000,1000,1000,2023-01-03,2023-01-25,0,22
54135.0,5482013,1000,0,1000,1000,2023-01-03,2023-01-18,0,15
54135.0,5482013,1000,1000,1000,1000,2023-01-25,2023-03-20,0,54
54135.0,5482013,1000,1000,1000,1000,2023-01-25,2023-03-07,0,41
54135.0,5482013,1000,1000,1000,1000,2023-01-25,2023-02-23,0,29
54135.0,5482013,1000,1000,1000,1000,2023-01-25,2023-03-13,0,47
54135.0,5482013,1000,1000,1000,0,2023-01-18,2023-03-07,1000,48
54135.0,5482013,1000,1000,1000,0,2023-01-18,2023-02-23,1000,36
54135.0,5482013,1000,1000,1000,0,2023-01-18,2023-03-13,1000,54
54135.0,5482013,1000,1000,1000,0,2023-01-18,2023-01-25,1000,7
54135.0,6979407,2,2,1,1,2022-12-27,2023-01-11,0,15
54135.0,6979407,2,2,1,1,2022-12-27,2023-01-18,0,22
54135.0,6979407,1,1,1,1,2022-12-27,2023-02-13,0,48
54135.0,6979407,2,0,2,2,2023-01-11,2023-03-07,0,55
54135.0,6979407,2,2,2,2,2023-01-11,2023-01-18,0,7
54135.0,6979407,2,0,2,2,2023-01-11,2023-02-27,0,47
54135.0,6979407,2,0,2,2,2023-01-18,2023-03-07,0,48
54135.0,6979407,2,0,2,2,2023-01-18,2023-02-27,0,40
54135.0,6979407,2,0,1,1,2023-02-13,2023-03-07,0,22
54135.0,6979407,2,0,1,1,2023-02-13,2023-02-27,0,14
54135.0,6979407,2,0,2,0,2023-02-27,2023-03-07,2,8
54135.0,6981402,3,3,2,0,2023-03-07,2023-03-22,2,15
54135.0,6981402,3,0,2,0,2023-03-07,2023-03-13,2,6
54135.0,6981402,3,3,3,0,2023-03-13,2023-03-22,3,9
54135.0,6981402,3,3,2,2,2023-02-27,2023-03-22,0,23
54135.0,6981402,2,0,2,2,2023-02-27,2023-03-07,0,8
54135.0,6981402,3,0,2,2,2023-02-27,2023-03-13,0,14
54135.0,8717714,1,1,1,0,2023-03-13,2023-03-22,1,9
54135.0,8720790,1,1,1,1,2022-12-27,2023-02-23,0,58
54135.0,8720790,4,4,1,1,2022-12-27,2023-01-03,0,7
54135.0,8720790,2,2,1,1,2022-12-27,2023-01-25,0,29
54135.0,8720790,2,2,1,1,2023-02-23,2023-03-07,0,12
54135.0,8720790,1,1,1,1,2023-02-23,2023-02-27,0,4
54135.0,8720790,2,2,2,2,2023-01-25,2023-03-07,0,41
54135.0,8720790,2,2,1,1,2023-02-27,2023-03-07,0,8
54155.0,3029395,10,10,8,8,2023-01-11,2023-02-09,0,29
54159.0,1105403,2,2,2,0,2023-01-30,2023-02-03,2,4
54159.0,1410406,5,5,4,0,2023-01-30,2023-02-03,4,4
54159.0,6979407,2,0,2,2,2023-01-30,2023-02-03,0,4
54261.0,5482401,4,4,2,2,2023-01-27,2023-03-14,0,46
54311.0,5406,2,2,2,2,2023-01-16,2023-03-14,0,57
54311.0,11403,2,2,2,0,2023-01-16,2023-01-19,2,3
54311.0,11403,2,2,2,0,2023-01-16,2023-03-14,2,57
54311.0,11403,2,2,2,2,2023-01-19,2023-03-14,0,54
54311.0,97403,2,2,2,2,2023-01-16,2023-03-14,0,57
54311.0,367012,2,2,2,0,2023-01-16,2023-01-19,2,3
54311.0,369026,3,3,3,0,2023-01-16,2023-01-19,3,3
54311.0,373019,2,2,2,0,2023-01-16,2023-01-19,2,3
54311.0,378019,2,2,2,0,2023-01-16,2023-01-19,2,3
54311.0,5482401,8,8,6,6,2023-01-16,2023-03-14,0,57
54311.0,1AA0004,2,2,2,0,2023-01-16,2023-01-19,2,3
54333.0,89400,6,6,4,4,2023-01-11,2023-02-20,0,40
54333.0,1AB2919,8,8,8,8,2023-01-11,2023-02-20,0,40
54349.0,6981402,5,5,4,4,2023-02-23,2023-03-10,0,15
54349.0,6981402,5,5,4,4,2023-02-23,2023-03-10,0,15
54400.0,3029395,10,10,10,10,2023-01-19,2023-03-08,0,48
54400.0,3029395,10,10,6,6,2023-02-03,2023-03-08,0,33
54400.0,6979407,4,4,2,2,2023-01-19,2023-02-03,0,15
54400.0,6979407,3,0,2,2,2023-01-19,2023-03-08,0,48
54475.0,546012,1,1,2,0,2023-03-07,2023-03-19,2,12
54501.0,91488,10,10,3,3,2023-01-06,2023-02-13,0,38
54501.0,97403,8,8,8,8,2023-01-06,2023-03-07,0,60
54501.0,5482401,14,14,14,14,2023-01-06,2023-03-07,0,60
54532.0,504010,1,0,1,0,2023-01-03,2023-01-18,1,15
54581.0,45626,10,10,6,6,2022-08-15,2022-08-16,0,1
54581.0,369026,6,6,3,3,2022-08-15,2022-08-16,0,1
54595.0,91488,4,4,4,4,2023-01-19,2023-03-13,0,53
54595.0,91488,4,4,2,2,2023-02-16,2023-03-13,0,25
54595.0,97403,6,6,5,5,2023-01-19,2023-01-20,0,1
54595.0,367012,2,2,2,2,2023-01-19,2023-02-16,0,28
54595.0,367012,3,3,2,2,2023-01-19,2023-03-13,0,53
54595.0,367012,3,3,2,2,2023-02-16,2023-03-13,0,25
54595.0,2305135,3,3,3,0,2023-02-16,2023-02-22,3,6
54595.0,2305135,4,4,3,0,2023-02-16,2023-03-13,3,25
54595.0,2305135,4,4,3,3,2023-02-22,2023-03-13,0,19
54595.0,4520400,1,1,1,1,2023-01-19,2023-03-13,0,53
54595.0,4907400,10,10,10,10,2022-12-21,2023-02-16,0,57
54595.0,5307401,1,1,1,1,2023-01-19,2023-02-16,0,28
54595.0,5307401,2,2,1,1,2023-01-19,2023-03-13,0,53
54595.0,5307401,2,2,1,1,2023-02-16,2023-03-13,0,25
54595.0,5482401,10,0,10,10,2023-01-19,2023-02-16,0,28
54595.0,5482401,10,0,10,10,2023-01-19,2023-02-22,0,34
54595.0,5482401,10,0,10,10,2023-01-19,2023-02-22,0,34
54595.0,5482401,10,10,10,10,2023-01-19,2023-02-28,0,40
54595.0,5482401,14,14,10,10,2023-01-19,2023-03-13,0,53
54595.0,5482401,10,0,10,0,2023-02-16,2023-02-22,10,6
54595.0,5482401,10,0,10,0,2023-02-16,2023-02-22,10,6
54595.0,5482401,10,10,10,0,2023-02-16,2023-02-28,10,12
54595.0,5482401,14,14,10,0,2023-02-16,2023-03-13,10,25
54595.0,5482401,10,10,10,0,2023-02-22,2023-02-28,10,6
54595.0,5482401,14,14,10,0,2023-02-22,2023-03-13,10,19
54595.0,5482401,10,10,10,0,2023-02-22,2023-02-28,10,6
54595.0,5482401,14,14,10,0,2023-02-22,2023-03-13,10,19
54595.0,5482401,14,14,10,10,2023-02-28,2023-03-13,0,13
54595.0,6598405,8,8,8,8,2023-01-19,2023-02-16,0,28
54595.0,6598405,18,18,8,8,2023-01-19,2023-03-13,0,53
54595.0,6598405,18,18,8,8,2023-02-16,2023-03-13,0,25
54595.0,6623400,18,18,10,10,2023-02-16,2023-03-13,0,25
54753.0,613019,2,2,2,0,2023-01-05,2023-01-24,2,19
54753.0,799215,2,2,2,0,2023-01-05,2023-01-24,2,19
54755.0,1412402,8,0,3,3,2023-01-16,2023-03-01,0,44
54799.0,14407,5,5,4,0,2023-01-19,2023-02-20,4,32
54799.0,5482401,3,3,2,2,2023-01-19,2023-02-20,0,32
54875.0,518011,1,1,1,0,2022-11-02,2022-11-18,1,16
54947.0,48406,2,2,3,0,2023-01-13,2023-01-26,3,13
54947.0,60400,1,1,1,0,2023-01-13,2023-01-26,1,13
54947.0,62349,1,1,4,0,2023-01-13,2023-01-26,4,13
54947.0,5482401,3,3,6,0,2023-01-13,2023-01-26,6,13
54947.0,8720790,2,2,4,0,2023-01-13,2023-01-26,4,13
54947.0,9511404,1,1,2,0,2023-01-13,2023-01-26,2,13
54957.0,504010,6,6,1,1,2023-02-06,2023-03-17,0,39
55006.0,1402403,8,8,8,0,2023-01-20,2023-01-25,8,5
55059.0,367012,3,3,3,3,2023-01-17,2023-02-23,0,37
55059.0,5482401,12,12,6,6,2023-01-17,2023-02-23,0,37
55102.0,541012,1,1,1,0,2023-01-20,2023-01-30,1,10
55102.0,9039059,2,2,2,0,2023-01-20,2023-01-30,2,10
55105.0,518011,1,1,1,1,2022-11-28,2023-01-19,0,52
55106.0,6623400,4,4,3,3,2023-01-05,2023-01-20,0,15
55111.0,89400,8,8,8,8,2023-01-09,2023-02-10,0,32
55111.0,89400,10,10,8,8,2023-02-10,2023-03-13,0,31
55111.0,233023,2,2,2,2,2023-01-09,2023-02-10,0,32
55111.0,367012,1,1,1,1,2023-01-09,2023-02-10,0,32
55111.0,374025,2,2,1,1,2023-01-09,2023-02-10,0,32
55111.0,4520400,4,4,4,4,2023-01-09,2023-02-10,0,32
55111.0,5482401,6,6,6,6,2023-01-09,2023-02-10,0,32
55111.0,1AA0004,1,1,1,1,2023-01-09,2023-02-10,0,32
55111.0,1AA0004,1,1,1,1,2023-02-10,2023-03-13,0,31
55111.0,1AB2691,1,1,1,1,2023-01-09,2023-02-10,0,32
55111.0,1AB2692,1,1,1,1,2023-01-09,2023-02-10,0,32
55118.0,4520400,3,3,1,1,2023-01-12,2023-03-02,0,49
55118.0,8720790,3,3,2,2,2023-01-12,2023-03-02,0,49
55125.0,24406,2,2,2,2,2023-01-19,2023-01-25,0,6
55125.0,97403,10,10,8,8,2023-01-19,2023-01-25,0,6
55125.0,311191,2,2,3,0,2023-01-19,2023-01-25,3,6
55125.0,313197,2,0,3,0,2023-01-19,2023-01-25,3,6
55125.0,313197,3,3,3,0,2023-01-19,2023-01-25,3,6
55125.0,313197,2,2,3,0,2023-01-19,2023-02-14,3,26
55125.0,313197,2,2,2,0,2023-01-25,2023-02-14,2,20
55125.0,315094,2,2,2,2,2023-01-19,2023-01-25,0,6
55125.0,367012,2,2,2,2,2023-01-19,2023-01-25,0,6
55125.0,374025,2,2,2,2,2023-01-19,2023-01-25,0,6
55125.0,1AA0004,2,2,2,2,2023-01-19,2023-01-25,0,6
55216.0,504010,1,1,1,0,2023-02-26,2023-03-07,1,9
55216.0,505018,2,2,2,0,2023-02-26,2023-03-07,2,9
55221.0,24406,2,2,2,2,2022-12-27,2023-02-07,0,42
55221.0,24406,2,2,2,2,2022-12-27,2023-01-30,0,34
55221.0,24406,2,2,2,2,2022-12-27,2023-01-27,0,31
55221.0,24406,2,2,2,2,2022-12-27,2023-01-23,0,27
55221.0,24406,2,2,2,2,2022-12-27,2023-01-17,0,21
55221.0,24406,2,2,2,2,2022-12-27,2023-02-17,0,52
55221.0,24406,2,2,2,2,2022-12-27,2023-02-16,0,51
55221.0,24406,2,2,2,2,2023-02-07,2023-03-15,0,36
55221.0,24406,2,2,2,2,2023-02-07,2023-03-15,0,36
55221.0,24406,2,2,2,2,2023-02-07,2023-02-27,0,20
55221.0,24406,2,2,2,2,2023-02-07,2023-02-17,0,10
55221.0,24406,2,2,2,2,2023-02-07,2023-02-16,0,9
55221.0,24406,2,2,2,2,2023-01-30,2023-02-07,0,8
55221.0,24406,2,2,2,2,2023-01-30,2023-03-15,0,44
55221.0,24406,2,2,2,2,2023-01-30,2023-03-15,0,44
55221.0,24406,2,2,2,2,2023-01-30,2023-02-27,0,28
55221.0,24406,2,2,2,2,2023-01-30,2023-02-17,0,18
55221.0,24406,2,2,2,2,2023-01-30,2023-02-16,0,17
55221.0,24406,2,2,2,2,2023-02-27,2023-03-15,0,16
55221.0,24406,2,2,2,2,2023-02-27,2023-03-15,0,16
55221.0,24406,2,2,2,2,2023-01-27,2023-02-07,0,11
55221.0,24406,2,2,2,2,2023-01-27,2023-03-15,0,47
55221.0,24406,2,2,2,2,2023-01-27,2023-03-15,0,47
55221.0,24406,2,2,2,2,2023-01-27,2023-01-30,0,3
55221.0,24406,2,2,2,2,2023-01-27,2023-02-27,0,31
55221.0,24406,2,2,2,2,2023-01-27,2023-02-17,0,21
55221.0,24406,2,2,2,2,2023-01-27,2023-02-16,0,20
55221.0,24406,2,2,1,1,2023-01-25,2023-02-07,0,13
55221.0,24406,2,2,1,1,2023-01-25,2023-03-15,0,49
55221.0,24406,2,2,1,1,2023-01-25,2023-03-15,0,49
55221.0,24406,2,2,1,1,2023-01-25,2023-01-30,0,5
55221.0,24406,2,2,1,1,2023-01-25,2023-02-27,0,33
55221.0,24406,2,2,1,1,2023-01-25,2023-01-27,0,2
55221.0,24406,2,2,1,1,2023-01-25,2023-02-17,0,23
55221.0,24406,2,2,1,1,2023-01-25,2023-02-16,0,22
55221.0,24406,2,2,2,2,2023-01-23,2023-02-07,0,15
55221.0,24406,2,2,2,2,2023-01-23,2023-03-15,0,51
55221.0,24406,2,2,2,2,2023-01-23,2023-03-15,0,51
55221.0,24406,2,2,2,2,2023-01-23,2023-01-30,0,7
55221.0,24406,2,2,2,2,2023-01-23,2023-02-27,0,35
55221.0,24406,2,2,2,2,2023-01-23,2023-01-27,0,4
55221.0,24406,2,2,2,2,2023-01-23,2023-02-17,0,25
55221.0,24406,2,2,2,2,2023-01-23,2023-02-16,0,24
55221.0,24406,2,2,2,2,2023-01-17,2023-02-07,0,21
55221.0,24406,2,2,2,2,2023-01-17,2023-03-15,0,57
55221.0,24406,2,2,2,2,2023-01-17,2023-03-15,0,57
55221.0,24406,2,2,2,2,2023-01-17,2023-01-30,0,13
55221.0,24406,2,2,2,2,2023-01-17,2023-02-27,0,41
55221.0,24406,2,2,2,2,2023-01-17,2023-01-27,0,10
55221.0,24406,2,2,2,2,2023-01-17,2023-01-23,0,6
55221.0,24406,2,2,2,2,2023-01-17,2023-02-17,0,31
55221.0,24406,2,2,2,2,2023-01-17,2023-02-16,0,30
55221.0,24406,2,2,2,2,2023-02-17,2023-03-15,0,26
55221.0,24406,2,2,2,2,2023-02-17,2023-03-15,0,26
55221.0,24406,2,2,2,2,2023-02-17,2023-02-27,0,10
55221.0,24406,2,2,2,2,2023-02-16,2023-03-15,0,27
55221.0,24406,2,2,2,2,2023-02-16,2023-03-15,0,27
55221.0,24406,2,2,2,2,2023-02-16,2023-02-27,0,11
55221.0,24406,2,2,2,2,2023-02-16,2023-02-17,0,1
55221.0,34405,2,2,2,2,2023-01-03,2023-02-27,0,55
55221.0,34405,2,2,2,2,2023-01-03,2023-01-11,0,8
55221.0,34405,4,4,2,2,2023-01-03,2023-01-23,0,20
55221.0,34405,4,4,2,2,2023-02-27,2023-03-15,0,16
55221.0,34405,2,2,2,2,2023-01-11,2023-02-27,0,47
55221.0,34405,4,4,2,2,2023-01-11,2023-01-23,0,12
55221.0,34405,4,4,4,4,2023-01-23,2023-03-15,0,51
55221.0,5482401,2,2,1,1,2023-01-06,2023-02-27,0,52
55221.0,6979407,1,1,1,1,2022-12-27,2023-02-07,0,42
55221.0,6979407,1,1,1,1,2022-12-27,2023-01-30,0,34
55221.0,6979407,1,1,1,1,2022-12-27,2023-01-27,0,31
55221.0,6979407,1,1,1,1,2022-12-27,2023-01-17,0,21
55221.0,6979407,1,0,1,1,2022-12-27,2023-02-16,0,51
55221.0,6979407,1,0,1,1,2022-05-09,2022-05-18,0,9
55221.0,6979407,1,1,1,1,2022-05-09,2022-05-18,0,9
55221.0,6979407,1,0,1,1,2022-05-09,2022-05-18,0,9
55221.0,6979407,1,0,1,1,2023-02-07,2023-02-27,0,20
55221.0,6979407,1,0,1,1,2023-02-07,2023-02-16,0,9
55221.0,6979407,1,1,1,1,2023-02-07,2023-03-01,0,22
55221.0,6979407,1,1,1,1,2023-01-30,2023-02-07,0,8
55221.0,6979407,1,0,1,1,2023-01-30,2023-02-27,0,28
55221.0,6979407,1,0,1,1,2023-01-30,2023-02-16,0,17
55221.0,6979407,1,1,1,1,2023-01-30,2023-03-01,0,30
55221.0,6979407,1,1,1,0,2023-02-27,2023-03-01,1,2
55221.0,6979407,1,1,1,1,2023-01-27,2023-02-07,0,11
55221.0,6979407,1,1,1,1,2023-01-27,2023-01-30,0,3
55221.0,6979407,1,0,1,1,2023-01-27,2023-02-27,0,31
55221.0,6979407,1,0,1,1,2023-01-27,2023-02-16,0,20
55221.0,6979407,1,1,1,1,2023-01-27,2023-03-01,0,33
55221.0,6979407,1,1,1,1,2023-01-17,2023-02-07,0,21
55221.0,6979407,1,1,1,1,2023-01-17,2023-01-30,0,13
55221.0,6979407,1,0,1,1,2023-01-17,2023-02-27,0,41
55221.0,6979407,1,1,1,1,2023-01-17,2023-01-27,0,10
55221.0,6979407,1,0,1,1,2023-01-17,2023-02-16,0,30
55221.0,6979407,1,1,1,1,2023-01-17,2023-03-01,0,43
55221.0,6979407,1,0,1,0,2023-02-16,2023-02-27,1,11
55221.0,6979407,1,1,1,0,2023-02-16,2023-03-01,1,13
55235.0,91488,2,2,1,1,2023-03-09,2023-03-27,0,18
55235.0,1676404,4,4,4,4,2023-02-09,2023-03-03,0,22
55235.0,1676404,6,6,4,4,2023-02-09,2023-03-27,0,46
55235.0,1676404,6,6,3,3,2023-03-09,2023-03-27,0,18
55235.0,1676404,6,6,4,4,2023-03-03,2023-03-27,0,24
55276.0,97403,4,4,4,4,2023-01-20,2023-03-08,0,47
55276.0,5482401,5,5,5,5,2023-01-20,2023-03-08,0,47
55277.0,9097016,1,1,1,1,2022-12-19,2023-01-26,0,38
55277.0,9097016,1,1,1,1,2022-12-19,2023-02-16,0,59
55277.0,9097016,1,1,1,1,2023-01-26,2023-02-16,0,21
55278.0,313197,1,1,1,0,2023-01-13,2023-02-01,1,19
55278.0,319096,1,1,1,0,2023-01-13,2023-02-01,1,19
55282.0,8720790,3,0,1,1,2023-01-19,2023-03-09,0,49
55283.0,8720790,6,6,6,0,2023-02-06,2023-03-03,6,25
55382.0,97403,12,12,10,10,2023-01-18,2023-03-06,0,47
55422.0,92403,4,0,4,0,2023-01-23,2023-02-28,4,36
55422.0,2805101,12,12,12,0,2023-01-23,2023-02-28,12,36
55434.0,97403,2,2,2,2,2023-01-09,2023-01-31,0,22
55434.0,373019,1,1,1,1,2023-01-09,2023-01-31,0,22
55434.0,373019,2,0,1,1,2023-01-09,2023-01-31,0,22
55434.0,5482401,5,5,2,2,2023-01-09,2023-01-31,0,22
55434.0,8720774,1,0,1,0,2023-01-09,2023-01-31,1,22
55434.0,8720774,1,1,1,0,2023-01-09,2023-01-31,1,22
55434.0,9511404,1,1,1,1,2023-01-09,2023-01-31,0,22
55434.0,1AB2919,8,8,40,0,2023-01-09,2023-01-31,40,22
55459.0,11403,4,4,2,0,2023-03-06,2023-03-07,2,1
55459.0,48406,1,1,2,0,2023-03-06,2023-03-07,2,1
55459.0,97403,3,3,4,0,2023-03-06,2023-03-07,4,1
55459.0,173062,1,0,1,0,2023-03-06,2023-03-07,1,1
55459.0,367012,2,2,4,0,2023-03-06,2023-03-07,4,1
55459.0,369026,2,2,4,0,2023-03-06,2023-03-07,4,1
55459.0,5482401,4,4,1,1,2023-03-06,2023-03-07,0,1
55459.0,1AA0004,2,2,4,0,2023-03-06,2023-03-07,4,1
55497.0,14407,4,4,4,4,2023-01-03,2023-02-10,0,38
55498.0,504010,2,2,2,0,2022-12-21,2023-02-12,2,53
55498.0,505018,4,4,4,0,2022-12-21,2023-02-12,4,53
55498.0,725012,1,1,1,0,2022-12-21,2023-02-12,1,53
55595.0,1402403,27,27,38,0,2023-03-02,2023-03-08,38,6
55595.0,8720790,3,0,3,0,2023-03-02,2023-03-08,3,6
55595.0,1AA8987,1,1,3,0,2023-03-02,2023-03-08,3,6
55602.0,521014,1,1,1,0,2023-01-10,2023-01-24,1,14
55613.0,5406,3,3,3,0,2023-01-18,2023-02-01,3,14
55613.0,6598405,3,3,3,0,2023-01-18,2023-02-01,3,14
55618.0,5483409,2,2,2,2,2023-02-16,2023-02-27,0,11
55654.0,97403,3,3,3,3,2023-01-17,2023-03-15,0,57
55654.0,4226404,3,3,2,2,2022-12-08,2023-01-17,0,40
55654.0,5483409,1,1,1,1,2023-01-17,2023-03-15,0,57
55654.0,6598405,3,3,1,1,2023-01-17,2023-03-15,0,57
55654.0,6623400,5,5,1,1,2022-12-08,2023-01-17,0,40
55654.0,1AB2759,1,1,1,0,2022-12-08,2022-12-22,1,14
55686.0,1402403,8,8,8,8,2023-01-16,2023-02-24,0,39
55686.0,5482401,4,4,4,4,2023-01-16,2023-02-24,0,39
55739.0,1AB3449,1,1,1,1,2023-01-10,2023-03-08,0,57
55766.0,829012,1,1,2,0,2023-01-09,2023-03-09,2,59
55787.0,6979407,7,0,5,5,2023-01-25,2023-02-24,0,30
55901.0,549024,1,1,1,0,2023-02-06,2023-02-23,1,17
55917.0,8720790,5,5,5,0,2023-01-25,2023-02-08,5,14
56011.0,51409,1,1,1,1,2023-02-24,2023-02-28,0,4
56011.0,4608404,4,0,1,1,2023-02-24,2023-02-28,0,4
56011.0,8720774,2,2,2,0,2023-02-24,2023-02-28,2,4
56011.0,9511404,1,1,1,1,2023-02-24,2023-02-28,0,4
56011.0,1AB2919,5,5,5,5,2023-02-24,2023-02-28,0,4
56021.0,505018,8,8,8,0,2023-01-23,2023-02-24,8,32
56032.0,14407,4,4,4,4,2022-12-22,2023-02-14,0,54
56032.0,829004,2,2,5,0,2023-02-14,2023-03-06,5,20
56032.0,4064408,1,1,1,1,2022-12-22,2023-02-14,0,54
56032.0,8720790,2,2,2,2,2022-12-22,2023-02-14,0,54
56048.0,504010,3,3,2,2,2023-01-10,2023-02-20,0,41
56048.0,505018,7,7,5,5,2023-01-10,2023-02-20,0,41
56071.0,91488,2,2,2,2,2022-12-01,2023-01-11,0,41
56071.0,367012,2,2,2,2,2022-12-01,2023-01-11,0,41
56071.0,378019,2,2,2,2,2022-12-01,2023-01-11,0,41
56071.0,8740012,5,5,4,0,2022-12-01,2023-01-24,4,54
56071.0,8740012,4,4,4,0,2022-12-01,2023-01-26,4,56
56071.0,8740012,5,0,4,0,2022-12-01,2023-01-11,4,41
56071.0,8740012,5,5,5,0,2023-01-11,2023-01-24,5,13
56071.0,8740012,4,4,5,0,2023-01-11,2023-01-26,5,15
56093.0,5482401,4,4,3,3,2023-01-09,2023-01-25,0,16
56093.0,9511404,4,4,4,0,2023-01-09,2023-01-25,4,16
56110.0,367012,2,2,1,1,2023-01-27,2023-02-01,0,5
56110.0,571019,1,1,1,1,2023-02-01,2023-02-21,0,20
56214.0,6979407,16,0,5,0,2023-02-23,2023-02-24,5,1
56214.0,6981402,16,16,5,5,2023-02-23,2023-02-24,0,1
56233.0,2101046,9,9,9,0,2022-11-21,2023-01-04,9,44
56261.0,5482401,6,6,2,2,2022-11-28,2022-12-14,0,16
56261.0,5483409,4,4,2,2,2022-11-28,2022-12-14,0,16
56327.0,5406,6,6,3,3,2023-01-27,2023-03-06,0,38
56327.0,24406,8,8,3,3,2023-01-27,2023-03-06,0,38
56328.0,6598405,10,10,10,10,2023-01-05,2023-02-07,0,33
56358.0,25628,2,2,2,2,2023-01-16,2023-02-14,0,29
56445.0,634049,4,4,4,0,2023-01-09,2023-01-27,4,18
56445.0,1105403,2,2,2,0,2023-01-09,2023-01-27,2,18
56454.0,504010,5,5,5,0,2023-02-06,2023-02-09,5,3
56454.0,505018,10,10,10,0,2023-02-06,2023-02-09,10,3
56454.0,571019,2,2,2,0,2023-02-06,2023-02-09,2,3
56454.0,829053,2,0,1,0,2023-02-06,2023-02-09,1,3
56501.0,45626,6,6,6,0,2023-02-07,2023-03-27,6,48
56599.0,14407,4,4,4,0,2022-12-27,2022-12-30,4,3
56700.0,5482401,3,3,3,3,2023-01-25,2023-02-22,0,28
56737.0,504010,3,3,2,2,2023-01-29,2023-03-13,0,43
56737.0,505018,6,6,5,5,2023-01-29,2023-03-13,0,43
56764.0,542010,4,4,3,3,2023-01-12,2023-03-05,0,52
56764.0,543018,4,4,3,3,2023-01-12,2023-03-05,0,52
56764.0,548026,3,3,1,1,2023-01-12,2023-03-05,0,52
56773.0,4064408,1,1,1,0,2023-01-25,2023-02-20,1,26
56773.0,5482401,4,4,4,4,2023-01-25,2023-02-20,0,26
56773.0,6598405,3,3,3,0,2023-01-25,2023-02-20,3,26
56773.0,1AB2919,4,4,2,0,2023-01-25,2023-02-20,2,26
56774.0,91488,4,4,2,2,2023-01-26,2023-03-13,0,46
56785.0,394106,2,0,2,0,2023-02-06,2023-03-06,2,28
56785.0,394106,2,0,2,0,2023-02-06,2023-03-06,2,28
56785.0,8720790,4,4,3,0,2023-02-06,2023-03-06,3,28
56788.0,2805127,23,0,22,22,2023-02-09,2023-03-15,0,34
56788.0,2805127,23,23,22,22,2023-02-09,2023-03-22,0,41
56788.0,2805127,23,23,23,0,2023-03-15,2023-03-22,23,7
56788.0,3157139,2,2,8,0,2023-03-15,2023-03-22,8,7
56809.0,505018,5,5,5,5,2023-01-30,2023-03-12,0,41
56828.0,97403,10,10,6,6,2023-01-12,2023-02-07,0,26
56865.0,1628,1,1,1,0,2022-11-27,2023-01-18,1,52
56865.0,5482401,6,6,2,2,2022-11-27,2023-01-18,0,52
56909.0,394015,1,1,1,1,2023-01-05,2023-01-27,0,22
56925.0,783010,1,1,2,0,2023-02-01,2023-02-28,2,27
56925.0,787012,1,1,2,0,2023-02-01,2023-02-28,2,27
56929.0,373019,2,2,2,0,2023-02-03,2023-02-28,2,25
56929.0,388018,2,2,2,0,2023-02-03,2023-02-28,2,25
56991.0,571019,1,1,1,1,2023-03-20,2023-03-31,0,11
56993.0,5482401,7,7,2,2,2023-02-06,2023-03-20,0,42
57014.0,14407,2,2,2,0,2023-02-06,2023-02-10,2,4
57014.0,41400,2,2,2,0,2023-02-06,2023-02-10,2,4
57014.0,60400,1,0,1,0,2023-02-06,2023-02-10,1,4
57014.0,374025,1,0,1,0,2023-02-06,2023-02-10,1,4
57014.0,5482401,4,4,4,0,2023-02-06,2023-02-10,4,4
57019.0,829012,3,3,3,3,2023-02-14,2023-02-22,0,8
57019.0,4757409,6,0,6,0,2023-01-26,2023-02-14,6,19
57019.0,5482401,6,6,2,2,2023-01-26,2023-02-14,0,19
57085.0,523010,2,0,1,1,2022-12-29,2023-01-13,0,15
57093.0,1402403,12,12,9,9,2023-01-27,2023-03-01,0,33
57093.0,1402403,9,9,9,9,2023-01-27,2023-03-28,0,60
57114.0,2805127,30,30,25,25,2022-12-15,2023-02-10,0,57
57115.0,504010,1,1,1,1,2022-12-08,2023-02-05,0,59
57134.0,8720774,2,2,2,0,2022-12-28,2023-01-31,2,34
57181.0,364026,1,0,4,0,2023-01-23,2023-02-17,4,25
57181.0,5482401,2,2,3,0,2023-01-23,2023-02-08,3,16
57215.0,5406,1,1,1,0,2023-03-03,2023-03-07,1,4
57215.0,7402,1,1,1,0,2023-03-03,2023-03-07,1,4
57215.0,24406,4,4,4,0,2023-03-03,2023-03-07,4,4
57215.0,97403,3,3,3,0,2023-03-03,2023-03-07,3,4
57215.0,367012,2,2,2,0,2023-03-03,2023-03-07,2,4
57215.0,369026,2,2,2,0,2023-03-03,2023-03-07,2,4
57215.0,4757409,5,0,5,0,2023-03-03,2023-03-07,5,4
57215.0,5482401,5,5,5,0,2023-03-03,2023-03-07,5,4
57215.0,1AA0004,2,2,2,0,2023-03-03,2023-03-07,2,4
57248.0,1105403,2,2,2,0,2023-01-16,2023-02-09,2,24
57248.0,6598405,1,1,1,1,2023-01-16,2023-02-09,0,24
57257.0,91488,13,13,13,13,2022-12-27,2023-02-16,0,51
57257.0,225012,2,2,2,2,2022-12-27,2023-02-16,0,51
57257.0,233023,1,1,1,1,2022-12-27,2023-02-16,0,51
57257.0,309170,2,2,2,2,2022-12-27,2023-02-16,0,51
57257.0,309170,2,2,2,2,2022-12-07,2022-12-27,0,20
57257.0,365016,1,1,1,1,2022-12-27,2023-02-16,0,51
57257.0,367012,2,2,2,2,2022-12-27,2023-02-16,0,51
57257.0,373019,1,1,1,1,2022-12-27,2023-02-16,0,51
57257.0,374025,1,1,1,1,2022-12-27,2023-02-16,0,51
57257.0,378019,1,1,1,1,2022-12-27,2023-02-16,0,51
57257.0,387010,1,1,1,1,2022-12-27,2023-02-16,0,51
57257.0,387028,4,4,4,4,2022-12-27,2023-02-16,0,51
57257.0,387028,4,4,3,3,2022-12-07,2022-12-27,0,20
57257.0,388018,1,1,1,1,2022-12-27,2023-02-16,0,51
57257.0,388018,1,1,1,1,2022-12-07,2022-12-27,0,20
57257.0,4226404,2,2,2,2,2022-12-27,2023-02-16,0,51
57257.0,4520400,6,6,6,6,2022-12-27,2023-02-16,0,51
57257.0,4520400,6,6,6,6,2022-12-07,2022-12-27,0,20
57257.0,4907400,27,27,40,0,2022-12-27,2023-01-11,40,15
57257.0,4907400,40,40,40,0,2022-12-27,2023-02-16,40,51
57257.0,4907400,40,40,27,27,2023-01-11,2023-02-16,0,36
57257.0,5307401,4,0,4,0,2022-12-27,2023-01-11,4,15
57257.0,5307401,4,0,4,0,2022-12-27,2023-01-11,4,15
57257.0,5307401,4,0,4,0,2022-12-27,2023-02-16,4,51
57257.0,5307401,4,0,4,4,2022-10-31,2022-12-27,0,57
57257.0,5307401,4,0,4,0,2023-01-11,2023-02-16,4,36
57257.0,5307401,4,0,4,0,2023-01-11,2023-02-16,4,36
57257.0,5482401,16,16,12,12,2022-12-27,2023-02-16,0,51
57257.0,5482401,12,12,10,10,2022-12-07,2022-12-27,0,20
57257.0,6598405,16,16,15,15,2022-12-07,2022-12-27,0,20
57257.0,6598405,16,16,16,16,2022-12-27,2023-02-16,0,51
57257.0,6623400,14,14,14,14,2022-12-27,2023-02-16,0,51
57257.0,1AA0003,1,1,1,1,2022-12-27,2023-02-16,0,51
57257.0,1AA0003,1,1,1,1,2022-12-07,2022-12-27,0,20
57257.0,1AA0004,4,4,4,4,2022-12-27,2023-02-16,0,51
57257.0,1AA0004,4,4,3,3,2022-12-07,2022-12-27,0,20
57265.0,1AB2919,3,3,2,2,2023-02-09,2023-03-14,0,33
57283.0,1AA0004,3,3,3,3,2023-01-12,2023-03-06,0,53
57294.0,725012,7,7,1,1,2023-01-12,2023-03-10,0,57
57295.0,504010,2,2,2,2,2023-01-16,2023-03-07,0,50
57295.0,505018,4,4,4,4,2023-01-16,2023-03-07,0,50
57366.0,571019,2,0,1,1,2023-01-09,2023-02-13,0,35
57421.0,2805127,24,24,24,24,2022-12-30,2023-02-15,0,47
57421.0,2805127,24,24,24,24,2022-12-30,2023-01-10,0,11
57421.0,2805127,24,24,24,24,2023-01-10,2023-02-15,0,36
57487.0,7402,1,1,1,0,2023-01-03,2023-01-12,1,9
57487.0,62349,2,2,2,0,2023-01-03,2023-01-12,2,9
57487.0,97403,2,0,2,0,2023-01-03,2023-01-12,2,9
57487.0,1401405,4,0,4,0,2023-01-03,2023-01-12,4,9
57487.0,4064408,1,1,1,0,2023-01-03,2023-01-12,1,9
57487.0,5482401,8,8,8,0,2023-01-03,2023-01-12,8,9
57487.0,9511404,1,1,1,0,2023-01-03,2023-01-12,1,9
57493.0,5406,5,5,5,0,2023-02-21,2023-02-28,5,7
57493.0,5406,5,0,5,0,2023-02-21,2023-02-28,5,7
57493.0,11403,4,4,4,0,2023-02-28,2023-03-13,4,13
57493.0,11403,4,4,4,0,2023-02-28,2023-03-13,4,13
57493.0,11403,4,0,4,0,2023-02-21,2023-02-28,4,7
57493.0,11403,4,0,4,0,2023-02-21,2023-02-28,4,7
57493.0,11403,4,4,4,0,2023-02-21,2023-03-13,4,20
57493.0,11403,4,0,4,0,2023-02-21,2023-02-28,4,7
57493.0,11403,4,0,4,0,2023-02-21,2023-02-28,4,7
57493.0,11403,4,4,4,0,2023-02-21,2023-03-13,4,20
57493.0,24406,2,0,2,0,2023-02-21,2023-02-28,2,7
57493.0,24406,2,2,2,0,2023-02-21,2023-02-28,2,7
57493.0,51409,3,0,3,0,2023-02-21,2023-02-28,3,7
57493.0,51409,1,0,3,0,2023-02-21,2023-02-28,3,7
57493.0,91488,4,0,4,0,2023-02-21,2023-02-28,4,7
57493.0,91488,2,2,4,0,2023-02-21,2023-02-28,4,7
57493.0,313197,2,0,2,0,2023-02-21,2023-02-28,2,7
57493.0,313197,1,1,2,0,2023-02-21,2023-02-28,2,7
57493.0,315094,1,0,1,0,2023-02-21,2023-02-28,1,7
57493.0,315094,1,0,1,0,2023-02-21,2023-02-28,1,7
57493.0,315094,1,0,1,1,2023-02-21,2023-02-28,0,7
57493.0,315094,1,0,1,1,2023-02-21,2023-02-28,0,7
57493.0,367012,2,0,2,2,2023-02-21,2023-02-28,0,7
57493.0,367012,2,0,2,2,2023-02-21,2023-02-28,0,7
57493.0,369018,2,2,3,0,2023-02-21,2023-02-28,3,7
57493.0,369018,3,0,3,0,2023-02-21,2023-02-28,3,7
57493.0,373019,2,0,2,2,2023-02-21,2023-02-28,0,7
57493.0,373019,2,0,2,2,2023-02-21,2023-02-28,0,7
57493.0,378019,2,0,2,2,2023-02-21,2023-02-28,0,7
57493.0,378019,2,0,2,2,2023-02-21,2023-02-28,0,7
57493.0,388018,1,0,1,0,2023-02-21,2023-02-28,1,7
57493.0,388018,1,1,1,0,2023-02-21,2023-02-28,1,7
57493.0,4226404,2,0,2,0,2023-02-21,2023-02-28,2,7
57493.0,4226404,2,2,2,0,2023-02-21,2023-02-28,2,7
57493.0,5482401,4,0,4,0,2023-02-21,2023-02-28,4,7
57493.0,5482401,1,1,4,0,2023-02-21,2023-02-28,4,7
57493.0,6968020,3,0,3,0,2023-02-21,2023-02-28,3,7
57493.0,6968020,3,3,3,0,2023-02-21,2023-02-28,3,7
57493.0,8720774,2,0,2,0,2023-02-21,2023-02-28,2,7
57493.0,8720774,2,2,2,0,2023-02-21,2023-02-28,2,7
57493.0,8720790,4,0,4,0,2023-02-21,2023-02-28,4,7
57493.0,8720790,4,4,4,0,2023-02-21,2023-02-28,4,7
57493.0,9511404,2,0,2,0,2023-02-21,2023-02-28,2,7
57493.0,9511404,3,3,2,0,2023-02-21,2023-02-28,2,7
57493.0,1AA0004,3,3,3,0,2023-02-21,2023-02-28,3,7
57493.0,1AA0004,3,0,3,0,2023-02-21,2023-02-28,3,7
57508.0,97403,4,4,4,4,2022-12-21,2023-01-10,0,20
57523.0,8400,2,2,1,1,2023-01-24,2023-02-06,0,13
57562.0,24406,2,2,2,0,2023-02-07,2023-03-06,2,27
57562.0,5482401,5,5,5,5,2023-02-07,2023-03-06,0,27
57567.0,829012,1,0,2,0,2023-01-18,2023-03-02,2,43
57567.0,6598405,2,2,2,0,2023-01-18,2023-03-16,2,57
57567.0,6598405,2,0,2,0,2023-01-18,2023-02-23,2,36
57567.0,6598405,2,0,2,0,2023-01-18,2023-02-23,2,36
57567.0,6598405,2,2,2,0,2023-02-23,2023-03-16,2,21
57567.0,6598405,2,2,2,0,2023-02-23,2023-03-16,2,21
57567.0,1AB2735,2,0,2,0,2023-01-18,2023-03-16,2,57
57567.0,1AB2735,2,0,2,0,2023-01-18,2023-02-23,2,36
57567.0,1AB2735,2,0,2,0,2023-01-18,2023-02-23,2,36
57567.0,1AB2735,2,0,2,0,2023-02-23,2023-03-16,2,21
57567.0,1AB2735,2,0,2,0,2023-02-23,2023-03-16,2,21
57585.0,1105403,4,0,4,0,2023-01-30,2023-03-14,4,43
57585.0,5482401,4,4,3,3,2023-01-30,2023-03-14,0,43
57594.0,1AA9008,1,1,1,0,2023-02-03,2023-03-01,1,26
57638.0,6979407,8,0,6,6,2023-02-16,2023-02-24,0,8
57643.0,6598405,5,5,3,3,2023-01-16,2023-02-17,0,32
57643.0,8720790,2,2,2,0,2023-01-16,2023-02-17,2,32
57695.0,5406,11,0,2,2,2023-01-09,2023-01-11,0,2
57696.0,1AA8981,1,1,1,0,2023-01-06,2023-01-09,1,3
57713.0,2805127,50,50,50,50,2023-01-16,2023-02-21,0,36
57713.0,5482401,2,2,2,2,2023-01-10,2023-03-09,0,58
57713.0,6598405,3,3,1,1,2023-01-10,2023-02-08,0,29
57713.0,8720790,2,2,2,2,2023-02-08,2023-03-09,0,29
57773.0,14407,6,6,6,0,2023-01-04,2023-02-06,6,33
57778.0,8400,1,1,1,1,2023-01-06,2023-01-24,0,18
57778.0,16403,2,2,2,2,2023-01-06,2023-01-24,0,18
57778.0,24406,4,4,4,4,2023-01-06,2023-01-24,0,18
57778.0,62349,1,1,1,1,2023-01-06,2023-01-24,0,18
57778.0,91488,2,2,2,2,2023-01-06,2023-01-24,0,18
57778.0,97403,4,4,4,4,2023-01-06,2023-01-24,0,18
57778.0,221010,1,1,1,1,2023-01-06,2023-01-24,0,18
57778.0,225012,1,1,1,1,2023-01-06,2023-01-24,0,18
57778.0,365016,1,1,1,1,2023-01-06,2023-01-24,0,18
57778.0,367012,1,1,1,1,2023-01-06,2023-01-24,0,18
57778.0,373019,1,1,1,1,2023-01-06,2023-01-24,0,18
57778.0,374025,1,1,1,1,2023-01-06,2023-01-24,0,18
57778.0,378019,1,1,1,1,2023-01-06,2023-01-24,0,18
57778.0,388018,1,1,1,1,2023-01-06,2023-01-24,0,18
57778.0,4064408,2,2,2,2,2023-01-06,2023-01-24,0,18
57778.0,4520400,2,2,2,2,2023-01-06,2023-01-24,0,18
57778.0,4608404,2,2,2,2,2023-01-06,2023-01-24,0,18
57778.0,5482401,6,6,6,6,2023-01-06,2023-01-24,0,18
57778.0,6598405,3,3,3,3,2023-01-06,2023-01-24,0,18
57778.0,6968020,1,1,1,1,2023-01-06,2023-01-24,0,18
57778.0,6968038,1,1,1,1,2023-01-06,2023-01-24,0,18
57778.0,8720790,2,2,2,2,2023-01-06,2023-01-24,0,18
57778.0,1AA0004,4,4,4,4,2023-01-06,2023-01-24,0,18
57778.0,1AB2690,1,1,1,1,2023-01-06,2023-01-24,0,18
57778.0,1AB2691,4,4,4,4,2023-01-06,2023-01-24,0,18
57778.0,1AB2692,4,4,4,4,2023-01-06,2023-01-24,0,18
57778.0,1AB2693,1,1,1,1,2023-01-06,2023-01-24,0,18
57780.0,60400,1,1,1,1,2023-02-07,2023-03-15,0,36
57818.0,25628,12,12,8,8,2023-02-01,2023-03-15,0,42
57818.0,89400,8,8,6,6,2023-02-16,2023-03-16,0,28
57818.0,6598405,18,18,6,6,2023-01-10,2023-02-16,0,37
57842.0,504010,6,6,4,4,2023-02-13,2023-03-02,0,17
57842.0,505018,8,8,8,8,2023-02-13,2023-03-02,0,17
57855.0,5482401,8,8,4,4,2023-01-05,2023-02-01,0,27
57920.0,8720790,4,4,10,0,2023-02-28,2023-03-15,10,15
57939.0,1240407,5,5,2,2,2023-02-01,2023-03-13,0,40
57954.0,1628,1,1,1,0,2023-03-02,2023-03-17,1,15
57954.0,1628,1,1,1,1,2023-03-02,2023-03-17,0,15
57954.0,7402,1,1,1,0,2023-03-02,2023-03-17,1,15
57954.0,7402,1,1,1,1,2023-03-02,2023-03-17,0,15
57954.0,11403,1,1,1,0,2023-03-02,2023-03-17,1,15
57954.0,11403,1,1,1,1,2023-03-02,2023-03-17,0,15
57954.0,91488,20,20,20,0,2023-03-02,2023-03-17,20,15
57954.0,91488,20,20,20,20,2023-03-02,2023-03-17,0,15
57954.0,97403,2,2,2,0,2023-03-02,2023-03-17,2,15
57954.0,97403,2,2,2,2,2023-03-02,2023-03-17,0,15
57954.0,233023,2,2,2,0,2023-03-02,2023-03-17,2,15
57954.0,233023,2,2,2,2,2023-03-02,2023-03-17,0,15
57954.0,387036,2,2,2,0,2023-03-02,2023-03-17,2,15
57954.0,387036,2,2,2,2,2023-03-02,2023-03-17,0,15
57954.0,4226404,3,3,3,0,2023-03-02,2023-03-17,3,15
57954.0,4226404,3,3,3,3,2023-03-02,2023-03-17,0,15
57954.0,4907400,20,20,12,12,2023-03-07,2023-03-17,0,10
57954.0,5963336,15,15,4,4,2023-03-07,2023-03-17,0,10
57954.0,6598405,4,4,4,0,2023-03-02,2023-03-17,4,15
57954.0,6598405,4,4,4,4,2023-03-02,2023-03-17,0,15
57954.0,1AA0003,1,1,1,0,2023-03-02,2023-03-17,1,15
57954.0,1AA0003,1,1,1,1,2023-03-02,2023-03-17,0,15
57955.0,225012,1,1,1,0,2022-12-30,2023-01-06,1,7
58015.0,574013,1,1,1,0,2023-02-21,2023-03-16,1,23
58061.0,725012,1,1,1,0,2023-01-05,2023-02-22,1,48
58085.0,4139409,13,13,13,0,2023-02-09,2023-02-15,13,6
58099.0,45626,2,2,3,0,2023-02-28,2023-03-03,3,3
58099.0,367012,2,2,2,0,2023-02-28,2023-03-03,2,3
58099.0,4139409,9,9,10,0,2023-02-28,2023-03-03,10,3
58179.0,1105403,10,10,4,0,2023-02-08,2023-02-09,4,1
58180.0,5406,3,3,1,1,2023-01-04,2023-02-01,0,28
58180.0,97403,6,6,1,1,2023-01-04,2023-02-01,0,28
58300.0,546012,1,1,1,0,2023-01-15,2023-01-17,1,2
58300.0,547010,1,1,1,0,2023-01-15,2023-01-17,1,2
58300.0,548026,1,1,1,0,2023-01-15,2023-01-17,1,2
58300.0,549024,1,1,1,0,2023-01-15,2023-01-17,1,2
58300.0,9037053,2,2,2,0,2023-01-15,2023-02-08,2,24
58300.0,9097016,2,2,2,0,2023-01-15,2023-01-17,2,2
58300.0,9098014,2,2,2,0,2023-01-15,2023-01-17,2,2
58333.0,661018,2,2,2,2,2023-02-02,2023-02-07,0,5
58397.0,504010,1,1,1,0,2023-02-27,2023-03-17,1,18
58419.0,328097,2,2,1,1,2023-01-10,2023-01-16,0,6
58430.0,562992,1,1,1,1,2022-12-04,2022-12-09,0,5
58430.0,1AA7969,1,1,1,1,2022-12-04,2022-12-09,0,5
58430.0,1AA9262,1,1,1,1,2022-12-04,2022-12-09,0,5
58430.0,1AA9262,1,1,1,1,2022-12-04,2022-12-09,0,5
58430.0,1AA9263,1,1,1,1,2022-12-04,2022-12-09,0,5
58430.0,1AA9264,1,1,1,1,2022-12-04,2022-12-09,0,5
58430.0,1AA9279,1,1,1,1,2022-12-04,2022-12-09,0,5
58430.0,1AA9280,1,1,1,1,2022-12-04,2022-12-09,0,5
58430.0,1AA9281,1,1,1,1,2022-12-04,2022-12-09,0,5
58430.0,1AA9283,1,1,1,1,2022-12-04,2022-12-09,0,5
58459.0,5406,4,4,4,0,2023-01-10,2023-01-11,4,1
58459.0,201020,1,0,1,1,2023-01-10,2023-01-11,0,1
58483.0,5406,4,4,4,4,2023-01-04,2023-01-05,0,1
58506.0,1412402,4,4,4,4,2023-01-22,2023-03-15,0,52
58506.0,5482401,2,2,2,2,2023-01-22,2023-03-15,0,52
58510.0,97403,4,4,1,1,2023-02-08,2023-03-10,0,30
58536.0,364018,1,1,1,0,2022-12-12,2023-02-01,1,51
58536.0,1426585,1,1,1,1,2022-12-02,2022-12-12,0,10
58536.0,9511404,3,3,3,0,2022-12-02,2023-01-27,3,56
58707.0,5406,2,2,2,2,2023-01-16,2023-02-08,0,23
58707.0,11403,2,2,1,1,2023-01-16,2023-02-08,0,23
58707.0,5482401,2,2,2,2,2023-01-16,2023-02-08,0,23
58707.0,1AB2735,1,1,1,1,2023-01-16,2023-02-08,0,23
58715.0,62349,4,4,1,1,2023-01-13,2023-03-07,0,53
58715.0,504010,2,2,4,0,2023-01-13,2023-03-07,4,53
58715.0,504010,2,0,4,0,2023-01-13,2023-03-07,4,53
58715.0,505018,10,10,6,6,2023-01-13,2023-03-07,0,53
58715.0,505018,10,0,6,6,2023-01-13,2023-03-07,0,53
58742.0,504010,3,3,3,0,2023-02-03,2023-03-01,3,26
58742.0,505018,9,9,9,0,2023-02-03,2023-03-01,9,26
58745.0,725012,3,3,1,1,2023-01-11,2023-01-25,0,14
58790.0,504010,6,6,6,0,2023-03-16,2023-03-20,6,4
58791.0,6623400,3,3,2,2,2023-01-30,2023-03-23,0,52
58825.0,6598405,3,3,3,3,2023-02-23,2023-03-13,0,18
58825.0,8720790,3,3,2,2,2023-02-23,2023-03-13,0,18
58825.0,1AB2919,3,3,3,3,2023-02-23,2023-03-13,0,18
58930.0,5482401,5,5,2,2,2022-12-29,2023-02-20,0,53
58986.0,97403,4,4,3,3,2023-02-10,2023-03-16,0,34
58986.0,97403,4,4,2,2,2023-02-15,2023-03-16,0,29
58986.0,1402403,8,8,6,6,2023-02-10,2023-02-15,0,5
58986.0,6598405,3,3,3,0,2023-02-15,2023-03-16,3,29
58986.0,6598405,3,3,3,3,2023-02-15,2023-03-16,0,29
59033.0,1AB2919,4,4,4,0,2023-01-18,2023-01-27,4,9
59066.0,725012,2,2,2,2,2023-01-10,2023-02-01,0,22
59068.0,367012,3,3,3,0,2023-01-18,2023-01-19,3,1
59068.0,373019,1,1,1,1,2023-01-18,2023-01-19,0,1
59068.0,378019,2,2,2,0,2023-01-18,2023-01-19,2,1
59068.0,387028,3,3,3,0,2023-01-18,2023-01-19,3,1
59068.0,5482401,8,8,8,0,2023-01-18,2023-01-19,8,1
59068.0,6598405,7,7,7,0,2023-01-18,2023-01-19,7,1
59068.0,6623400,2,2,2,0,2023-01-18,2023-01-19,2,1
59068.0,1AA0004,3,3,3,0,2023-01-18,2023-01-19,3,1
59069.0,6623400,6,6,3,3,2023-01-19,2023-03-15,0,55
59111.0,1628,3,3,3,0,2023-02-07,2023-02-09,3,2
59111.0,5406,3,3,3,0,2023-02-07,2023-02-09,3,2
59111.0,45626,2,2,2,0,2023-02-07,2023-02-09,2,2
59111.0,1AB2735,3,3,3,0,2023-02-07,2023-02-09,3,2
59114.0,571019,1,1,1,1,2023-01-19,2023-01-27,0,8
59127.0,8400,10,10,4,0,2023-01-16,2023-03-08,4,51
59127.0,8400,10,10,4,0,2023-01-16,2023-03-08,4,51
59128.0,367012,5,5,4,4,2023-02-03,2023-03-08,0,33
59128.0,374025,2,2,1,1,2023-02-03,2023-03-08,0,33
59128.0,5482401,8,8,3,3,2023-02-03,2023-03-08,0,33
59128.0,5482401,1,1,2,0,2023-02-03,2023-03-08,2,33
59128.0,5482401,8,8,2,0,2023-02-03,2023-03-08,2,33
59128.0,5483409,6,6,3,3,2023-02-03,2023-03-13,0,38
59128.0,5483409,6,6,2,0,2023-03-08,2023-03-13,2,5
59128.0,5483409,6,6,2,2,2023-03-08,2023-03-13,0,5
59198.0,8717714,1,1,1,0,2023-01-31,2023-02-15,1,15
59240.0,14407,4,4,6,0,2023-03-05,2023-03-17,6,12
59243.0,367012,8,8,4,4,2023-02-09,2023-02-23,0,14
59252.0,504010,4,4,4,4,2023-01-02,2023-02-27,0,56
59252.0,505018,8,8,8,8,2023-01-02,2023-02-27,0,56
59263.0,618019,1,1,1,1,2023-01-12,2023-01-13,0,1
59266.0,2805101,25,25,25,25,2023-01-17,2023-01-26,0,9
59270.0,5482401,8,8,8,8,2023-01-04,2023-02-28,0,55
59270.0,6598405,4,4,2,2,2022-11-08,2023-01-04,0,57
59270.0,6623400,4,4,1,1,2022-11-08,2023-01-04,0,57
59270.0,8740012,3,3,3,3,2023-01-04,2023-02-28,0,55
59271.0,367012,4,4,2,2,2023-01-19,2023-02-07,0,19
59279.0,5406,22,22,2,2,2023-01-24,2023-02-08,0,15
59279.0,24406,10,10,2,2,2023-01-24,2023-02-08,0,15
59279.0,369026,6,6,3,3,2023-01-24,2023-02-08,0,15
59279.0,8720790,3,3,3,0,2023-01-24,2023-02-22,3,29
59339.0,504010,1,1,1,0,2023-01-24,2023-02-10,1,17
59356.0,6598405,3,3,2,2,2023-02-09,2023-03-02,0,21
59356.0,6598405,2,2,2,2,2023-01-03,2023-02-09,0,37
59356.0,6598405,3,3,2,2,2023-01-03,2023-03-02,0,58
59356.0,6968038,3,3,3,3,2023-02-09,2023-03-02,0,21
59356.0,1AA0004,4,4,3,3,2023-01-03,2023-03-02,0,58
59365.0,91488,12,12,12,0,2023-01-12,2023-01-24,12,12
59365.0,97403,6,6,6,0,2023-01-12,2023-01-24,6,12
59365.0,365016,8,8,2,2,2023-01-12,2023-01-24,0,12
59365.0,365016,8,8,8,0,2023-01-12,2023-01-24,8,12
59365.0,367012,10,10,10,0,2023-01-12,2023-01-24,10,12
59365.0,374025,2,2,2,0,2023-01-12,2023-01-24,2,12
59365.0,378019,3,3,2,2,2023-01-12,2023-01-24,0,12
59365.0,378019,3,3,3,0,2023-01-12,2023-01-24,3,12
59365.0,388018,6,6,4,4,2023-01-12,2023-01-24,0,12
59365.0,388018,6,6,6,0,2023-01-12,2023-01-24,6,12
59366.0,5406,2,2,2,2,2023-01-29,2023-03-24,0,54
59366.0,97403,2,2,6,0,2023-01-29,2023-03-24,6,54
59366.0,97403,2,2,2,0,2023-01-29,2023-03-24,2,54
59366.0,4064408,1,0,1,1,2023-01-29,2023-03-24,0,54
59366.0,4064408,1,0,1,1,2023-01-29,2023-03-24,0,54
59367.0,1105403,2,2,4,0,2023-03-06,2023-03-19,4,13
59418.0,725012,2,2,1,1,2022-12-30,2023-02-10,0,42
59477.0,570094,1,1,1,1,2022-12-27,2023-01-04,0,8
59477.0,725012,3,3,3,3,2022-12-27,2023-01-04,0,8
59482.0,5406,2,2,2,2,2023-01-18,2023-02-14,0,27
59482.0,14407,6,0,6,6,2023-01-18,2023-02-14,0,27
59482.0,14407,3,3,6,0,2023-02-14,2023-03-08,6,22
59482.0,5482401,4,4,4,4,2023-01-18,2023-02-14,0,27
59482.0,1AB2191,1,1,1,1,2023-01-18,2023-02-14,0,27
59482.0,1AB5909,1,0,1,1,2023-01-18,2023-03-08,0,49
59482.0,1AB5909,1,0,1,1,2023-01-18,2023-02-14,0,27
59482.0,1AB5909,1,0,1,0,2023-02-14,2023-03-08,1,22
59483.0,7402,8,8,8,8,2023-01-10,2023-02-24,0,45
59483.0,62349,20,20,15,15,2023-01-10,2023-02-24,0,45
59483.0,97403,25,25,15,15,2023-01-10,2023-02-24,0,45
59518.0,129503,1,0,1,0,2022-12-15,2023-01-05,1,21
59518.0,526014,1,1,1,0,2022-12-15,2023-01-05,1,21
59518.0,535015,1,0,1,1,2022-12-15,2023-01-05,0,21
59518.0,536013,2,0,2,2,2022-12-15,2023-01-05,0,21
59518.0,542010,1,0,1,1,2022-12-15,2023-01-05,0,21
59518.0,543018,1,0,1,1,2022-12-15,2023-01-05,0,21
59518.0,546053,1,0,1,1,2022-12-15,2023-01-05,0,21
59518.0,547051,1,0,1,1,2022-12-15,2023-01-05,0,21
59518.0,661018,1,0,1,1,2022-12-15,2023-01-05,0,21
59518.0,700014,1,1,1,0,2022-12-15,2023-01-05,1,21
59518.0,701012,1,1,1,0,2022-12-15,2023-01-05,1,21
59518.0,702010,1,1,1,0,2022-12-15,2023-01-05,1,21
59518.0,703018,1,0,1,1,2022-12-15,2023-01-05,0,21
59518.0,9088015,1,0,1,1,2022-12-15,2023-01-05,0,21
59525.0,6598405,12,12,10,10,2022-12-20,2023-01-19,0,30
59525.0,6623400,6,6,6,6,2022-12-20,2023-01-19,0,30
59526.0,358011,1,1,1,1,2022-12-30,2023-02-06,0,38
59542.0,91488,6,6,6,6,2023-01-16,2023-03-09,0,52
59542.0,5482401,6,6,4,4,2023-01-16,2023-03-09,0,52
59542.0,8740012,3,3,2,2,2023-01-16,2023-03-09,0,52
59574.0,5406,4,4,1,1,2023-01-11,2023-01-16,0,5
59574.0,5406,14,14,1,1,2023-01-11,2023-01-16,0,5
59574.0,16403,2,2,1,1,2023-01-11,2023-01-16,0,5
59574.0,4064408,10,10,1,1,2023-01-11,2023-01-16,0,5
59574.0,4226404,5,5,4,0,2023-01-11,2023-01-16,4,5
59574.0,4520400,8,8,6,6,2023-01-11,2023-01-16,0,5
59574.0,4907400,2,2,2,2,2023-01-11,2023-01-16,0,5
59574.0,5482401,17,17,6,6,2023-01-11,2023-01-16,0,5
59574.0,5483409,1,1,1,1,2023-01-11,2023-01-16,0,5
59574.0,6598405,6,6,6,6,2023-01-11,2023-01-16,0,5
59574.0,9511404,1,1,1,1,2023-01-11,2023-01-16,0,5
59613.0,91488,2,2,1,1,2022-12-26,2023-01-30,0,35
59613.0,97403,1,1,1,1,2022-12-26,2023-01-30,0,35
59613.0,394106,1,0,1,0,2022-12-26,2023-01-30,1,35
59613.0,394106,1,1,1,0,2022-12-26,2023-02-15,1,51
59613.0,394106,1,1,1,0,2023-01-30,2023-02-15,1,16
59613.0,1412402,4,4,4,0,2022-12-26,2023-01-30,4,35
59613.0,4520400,2,2,1,1,2022-12-26,2023-01-30,0,35
59613.0,4757409,6,0,2,2,2022-12-26,2023-01-30,0,35
59613.0,4757409,6,0,4,0,2022-12-26,2023-01-30,4,35
59613.0,5482401,4,4,1,1,2022-12-26,2023-01-30,0,35
59613.0,6968038,2,2,2,0,2022-12-26,2023-01-30,2,35
59613.0,1AA0004,2,2,3,0,2022-12-26,2023-01-30,3,35
59613.0,1AB2733,1,1,1,0,2022-12-26,2023-01-30,1,35
59613.0,1AB2735,1,1,2,0,2022-12-26,2023-01-30,2,35
59613.0,1AB5909,1,1,1,0,2022-12-26,2023-01-30,1,35
59616.0,91488,12,12,12,12,2022-12-07,2023-01-20,0,44
59616.0,97403,5,5,5,5,2023-01-20,2023-02-17,0,28
59616.0,367012,6,6,2,2,2023-02-17,2023-03-13,0,24
59616.0,1660407,8,8,6,6,2023-03-03,2023-03-24,0,21
59616.0,4520400,5,5,5,5,2022-12-07,2023-01-20,0,44
59616.0,4520400,1,1,1,1,2023-02-17,2023-03-24,0,35
59616.0,4907400,12,12,12,12,2023-01-20,2023-02-17,0,28
59616.0,5307401,8,0,8,0,2022-12-07,2023-01-11,8,35
59616.0,5307401,8,0,8,0,2022-12-07,2023-01-20,8,44
59616.0,5307401,8,0,8,0,2022-12-07,2023-01-27,8,51
59616.0,5307401,4,0,8,0,2022-12-07,2023-01-11,8,35
59616.0,5307401,8,0,8,0,2022-12-07,2023-01-20,8,44
59616.0,5307401,8,0,4,4,2022-11-17,2022-12-07,0,20
59616.0,5307401,8,0,4,4,2022-11-17,2023-01-11,0,55
59616.0,5307401,4,0,4,4,2022-11-17,2023-01-11,0,55
59616.0,5307401,8,0,8,0,2023-01-11,2023-01-20,8,9
59616.0,5307401,8,0,8,0,2023-01-11,2023-02-17,8,37
59616.0,5307401,8,0,8,0,2023-01-11,2023-01-27,8,16
59616.0,5307401,8,0,8,0,2023-01-11,2023-01-20,8,9
59616.0,5307401,8,0,8,0,2023-01-20,2023-02-17,8,28
59616.0,5307401,8,0,8,0,2023-01-20,2023-01-27,8,7
59616.0,5307401,8,0,8,0,2023-01-27,2023-02-17,8,21
59616.0,5307401,8,0,4,0,2023-01-11,2023-01-20,4,9
59616.0,5307401,8,0,4,0,2023-01-11,2023-02-17,4,37
59616.0,5307401,8,0,4,0,2023-01-11,2023-01-27,4,16
59616.0,5307401,8,0,4,0,2023-01-11,2023-01-20,4,9
59616.0,5307401,8,0,8,0,2023-01-20,2023-02-17,8,28
59616.0,5307401,8,0,8,0,2023-01-20,2023-01-27,8,7
59616.0,5482401,10,10,10,10,2022-12-07,2023-01-20,0,44
59616.0,5482401,15,15,10,10,2023-01-20,2023-02-17,0,28
59616.0,5482401,15,15,15,15,2023-02-17,2023-03-24,0,35
59616.0,5482401,15,15,8,8,2023-03-13,2023-03-24,0,11
59616.0,6598405,8,8,8,8,2022-12-07,2023-01-20,0,44
59616.0,6598405,7,7,2,2,2023-02-17,2023-03-24,0,35
59616.0,6623400,6,6,6,0,2022-12-07,2023-01-20,6,44
59616.0,6623400,6,6,6,0,2022-12-07,2023-01-11,6,35
59616.0,6623400,6,6,6,6,2023-01-11,2023-01-20,0,9
59616.0,6623400,4,4,4,4,2023-02-17,2023-03-24,0,35
59671.0,24406,60,60,8,8,2022-12-13,2022-12-29,0,16
59671.0,24406,40,40,8,8,2022-12-13,2023-01-19,0,37
59671.0,24406,40,40,40,40,2023-01-19,2023-03-02,0,42
59671.0,4064408,15,15,4,4,2022-12-29,2023-01-26,0,28
59671.0,4907400,60,0,8,0,2022-12-13,2022-12-29,8,16
59671.0,5148409,40,40,40,40,2023-01-19,2023-03-02,0,42
59671.0,5482401,10,10,10,10,2022-12-29,2023-01-26,0,28
59683.0,89400,6,6,4,4,2022-12-29,2023-02-13,0,46
59683.0,89400,8,8,6,6,2023-02-13,2023-02-28,0,15
59683.0,97403,11,11,9,9,2022-12-29,2023-02-13,0,46
59683.0,97403,15,15,11,11,2023-02-13,2023-02-28,0,15
59683.0,221010,1,1,1,1,2022-12-29,2023-02-13,0,46
59683.0,309170,1,1,1,1,2022-12-29,2023-02-13,0,46
59683.0,309170,2,2,1,1,2023-02-13,2023-02-28,0,15
59683.0,367012,2,2,1,1,2022-12-29,2023-02-13,0,46
59683.0,367012,2,2,2,2,2023-02-13,2023-02-28,0,15
59683.0,3704138,4,4,3,3,2022-12-29,2023-02-13,0,46
59683.0,3704138,4,4,4,4,2023-02-13,2023-02-28,0,15
59683.0,4907400,16,16,16,16,2023-02-13,2023-02-28,0,15
59683.0,5963336,4,4,4,4,2022-12-29,2023-02-13,0,46
59683.0,5963336,4,4,4,4,2023-02-13,2023-02-28,0,15
59683.0,6598405,6,6,6,6,2022-12-29,2023-02-13,0,46
59683.0,6598405,6,6,6,6,2023-02-13,2023-02-28,0,15
59683.0,1AB2691,1,1,1,1,2022-12-29,2023-02-13,0,46
59683.0,1AB2691,1,1,1,1,2023-02-13,2023-02-28,0,15
59683.0,1AB2692,1,1,1,1,2022-12-29,2023-02-13,0,46
59683.0,1AB2692,1,1,1,1,2023-02-13,2023-02-28,0,15
59698.0,504010,4,4,4,0,2022-12-29,2023-01-03,4,5
59698.0,505018,2,0,2,0,2022-12-29,2023-01-03,2,5
59737.0,14407,2,0,2,2,2023-02-23,2023-03-01,0,6
59737.0,97403,4,0,3,3,2023-02-23,2023-03-01,0,6
59737.0,367012,8,0,2,2,2023-02-23,2023-03-01,0,6
59737.0,373019,6,0,1,1,2023-02-23,2023-03-01,0,6
59737.0,374025,3,0,1,1,2023-02-23,2023-03-01,0,6
59737.0,504010,2,0,2,2,2023-02-23,2023-03-01,0,6
59737.0,505018,2,0,2,2,2023-02-23,2023-03-01,0,6
59737.0,546012,1,0,1,1,2023-02-23,2023-03-01,0,6
59737.0,546053,1,1,1,0,2023-02-23,2023-03-01,1,6
59737.0,547010,1,0,1,1,2023-02-23,2023-03-01,0,6
59737.0,547051,1,1,1,0,2023-02-23,2023-03-01,1,6
59737.0,548026,1,0,1,1,2023-02-23,2023-03-01,0,6
59737.0,549024,1,0,1,1,2023-02-23,2023-03-01,0,6
59737.0,783010,1,1,1,0,2023-02-23,2023-03-01,1,6
59737.0,787012,1,1,1,0,2023-02-23,2023-03-01,1,6
59737.0,1105403,3,0,3,3,2023-02-23,2023-03-01,0,6
59737.0,1412402,3,0,3,0,2023-02-23,2023-03-01,3,6
59737.0,4907400,2,0,2,2,2023-02-23,2023-03-01,0,6
59737.0,5482401,4,0,2,2,2023-02-23,2023-03-01,0,6
59737.0,1AA0004,6,0,2,2,2023-02-23,2023-03-01,0,6
59747.0,387028,1,1,1,0,2023-01-20,2023-02-09,1,20
59747.0,6598405,3,3,3,0,2023-01-20,2023-02-09,3,20
59747.0,6979407,2,2,2,0,2023-01-20,2023-02-09,2,20
59753.0,5406,22,22,3,3,2023-01-03,2023-02-08,0,36
59759.0,97403,16,16,8,8,2022-12-19,2023-01-08,0,20
59759.0,97403,16,16,16,16,2023-01-08,2023-02-22,0,45
59759.0,504010,1,1,1,0,2023-02-22,2023-02-23,1,1
59759.0,505018,3,3,3,0,2023-02-22,2023-02-23,3,1
59771.0,57407,6,6,5,5,2022-12-20,2023-01-24,0,35
59771.0,91488,20,20,8,8,2022-12-16,2022-12-20,0,4
59771.0,5482401,20,20,20,20,2022-12-20,2023-01-26,0,37
59771.0,5482401,20,20,8,8,2022-12-16,2022-12-20,0,4
59771.0,5482401,20,20,8,8,2022-12-16,2023-01-26,0,41
59787.0,548026,1,1,1,1,2023-01-13,2023-02-16,0,34
59787.0,549024,1,1,1,1,2023-01-13,2023-02-16,0,34
59787.0,4608404,4,4,4,4,2022-11-29,2023-01-13,0,45
59788.0,957995,1,1,1,0,2023-01-23,2023-02-01,1,9
59793.0,799207,2,2,1,1,2023-01-17,2023-02-22,0,36
59819.0,505018,2,0,2,2,2023-03-03,2023-03-08,0,5
59834.0,5406,8,8,3,3,2023-02-17,2023-03-01,0,12
59834.0,97403,8,8,2,2,2023-02-17,2023-03-01,0,12
59834.0,4520400,5,5,2,2,2023-02-17,2023-03-01,0,12
59834.0,5482401,5,5,2,2,2023-02-17,2023-03-01,0,12
59834.0,6598405,8,8,3,3,2023-02-17,2023-03-01,0,12
59961.0,14407,3,3,3,3,2023-02-21,2023-03-15,0,22
60038.0,8720790,4,4,2,2,2023-01-23,2023-02-03,0,11
60061.0,548026,2,2,2,0,2022-12-23,2023-01-30,2,38
60061.0,549024,2,2,2,0,2022-12-23,2023-01-30,2,38
60061.0,616013,2,2,2,0,2022-12-23,2023-01-30,2,38
60061.0,618019,1,1,1,0,2022-12-23,2023-01-30,1,38
60098.0,725012,2,2,2,0,2022-12-22,2023-01-12,2,21
60101.0,5406,3,3,3,3,2023-01-13,2023-02-06,0,24
60101.0,97403,7,7,4,4,2023-01-13,2023-02-06,0,24
60101.0,1105403,4,4,4,4,2023-01-13,2023-02-06,0,24
60101.0,1402403,10,10,4,0,2023-01-13,2023-02-06,4,24
60158.0,41400,2,2,2,0,2022-12-27,2023-01-23,2,27
60158.0,91488,6,6,4,4,2022-12-27,2023-01-27,0,31
60158.0,91488,6,6,6,6,2023-01-27,2023-02-27,0,31
60158.0,97403,6,6,4,4,2022-12-27,2023-01-27,0,31
60158.0,97403,8,8,6,6,2023-01-27,2023-02-27,0,31
60158.0,97403,8,8,6,6,2023-01-27,2023-03-27,0,59
60158.0,97403,8,8,8,8,2023-02-27,2023-03-27,0,28
60158.0,367012,4,4,4,4,2022-12-27,2023-01-27,0,31
60158.0,388018,2,2,2,2,2022-12-27,2023-01-27,0,31
60158.0,5482401,12,12,10,10,2023-01-27,2023-02-27,0,31
60158.0,5482401,12,12,10,10,2023-01-27,2023-03-27,0,59
60158.0,5482401,12,12,12,12,2023-02-27,2023-03-27,0,28
60158.0,6598405,8,8,8,8,2022-12-27,2023-01-27,0,31
60158.0,6623400,4,4,4,4,2022-12-27,2023-01-27,0,31
60158.0,1AA0004,4,4,2,2,2022-12-27,2023-01-27,0,31
60186.0,5482401,40,40,40,40,2023-01-19,2023-02-28,0,40
60215.0,1AB2733,1,1,1,0,2022-11-15,2023-01-05,1,51
60258.0,92403,2,2,6,0,2023-01-12,2023-01-19,6,7
60258.0,8720790,4,0,3,0,2023-01-12,2023-02-21,3,40
60258.0,8740012,1,1,4,0,2023-01-12,2023-02-21,4,40
60355.0,1AB3456,3,3,1,1,2023-01-05,2023-02-24,0,50
60356.0,5482401,8,8,3,3,2023-01-02,2023-01-06,0,4
60356.0,1AB3451,3,3,3,3,2023-01-02,2023-01-06,0,4
60378.0,3029395,2,0,2,2,2023-02-22,2023-03-07,0,13
60378.0,3157139,3,0,3,0,2023-02-22,2023-03-07,3,13
60378.0,6968020,1,1,2,0,2023-02-22,2023-03-07,2,13
60378.0,6968038,2,2,2,0,2023-02-22,2023-03-07,2,13
60532.0,14407,3,3,3,3,2022-12-23,2023-01-09,0,17
60532.0,225012,1,1,1,1,2022-12-23,2023-01-09,0,17
60532.0,5482401,2,2,2,2,2022-12-23,2023-01-09,0,17
60576.0,504010,2,2,2,0,2023-03-01,2023-03-15,2,14
60576.0,504010,2,2,2,0,2023-03-01,2023-03-15,2,14
60736.0,5406,5,0,2,2,2022-12-07,2023-02-01,0,56
60736.0,5406,2,2,5,0,2023-02-01,2023-02-20,5,19
60736.0,58405,3,3,3,0,2023-02-01,2023-02-20,3,19
60736.0,60400,1,0,1,0,2023-02-01,2023-02-20,1,19
60736.0,97403,1,1,1,0,2023-02-01,2023-02-20,1,19
60736.0,6598405,2,0,2,2,2022-12-07,2023-02-01,0,56
60736.0,6598405,2,2,2,0,2023-02-01,2023-02-20,2,19
60736.0,9511404,1,0,1,1,2022-12-07,2023-02-01,0,56
60736.0,9511404,1,1,1,0,2023-02-01,2023-02-20,1,19
60740.0,364026,3,3,1,1,2023-01-24,2023-01-31,0,7
60816.0,504010,3,3,3,0,2022-12-23,2023-01-10,3,18
60816.0,505018,5,5,5,0,2022-12-23,2023-01-10,5,18
60819.0,504010,1,1,1,1,2023-01-11,2023-02-05,0,25
60819.0,505018,1,1,1,1,2023-01-11,2023-02-05,0,25
60821.0,1402403,4,4,3,3,2022-12-12,2023-02-06,0,56
60821.0,5483409,2,2,2,2,2022-12-12,2023-02-06,0,56
60837.0,547010,1,1,1,1,2023-02-09,2023-02-15,0,6
60870.0,1AB2919,5,5,5,0,2023-01-09,2023-01-16,5,7
60871.0,374025,2,2,2,0,2023-01-13,2023-02-17,2,35
60871.0,6598405,8,8,8,0,2023-01-13,2023-02-17,8,35
60871.0,8720790,4,4,4,0,2023-01-13,2023-02-17,4,35
60871.0,8740012,4,4,2,2,2023-01-13,2023-02-17,0,35
61013.0,14407,3,3,3,3,2023-01-09,2023-03-10,0,60
61013.0,24406,4,4,2,2,2023-01-09,2023-03-10,0,60
61013.0,4520400,2,2,2,2,2023-01-09,2023-03-10,0,60
61209.0,639023,1,1,5,0,2023-01-25,2023-02-03,5,9
61209.0,639023,5,0,5,0,2023-01-25,2023-02-03,5,9
61209.0,4608404,5,5,2,2,2023-01-25,2023-02-03,0,9
61209.0,7411010,1,1,1,0,2023-01-03,2023-02-27,1,55
61209.0,8110744,1,1,1,1,2023-01-25,2023-02-03,0,9
61209.0,1AB3454,2,2,1,1,2023-01-25,2023-02-03,0,9
61209.0,1AB3457,2,2,2,0,2023-01-25,2023-02-03,2,9
61212.0,200491,1,1,1,0,2023-01-25,2023-02-09,1,15
61212.0,200492,1,1,1,0,2023-01-25,2023-02-09,1,15
61212.0,9804015,1,1,1,0,2023-01-25,2023-02-09,1,15
61212.0,9897010,1,1,1,0,2023-01-25,2023-02-09,1,15
61260.0,97403,3,3,3,3,2023-02-05,2023-03-24,0,47
61260.0,614025,1,1,1,1,2023-02-05,2023-02-17,0,12
61260.0,631060,4,0,4,0,2023-02-05,2023-02-17,4,12
61260.0,685059,5,5,4,0,2023-02-05,2023-02-17,4,12
61260.0,688053,30,0,4,0,2023-02-05,2023-02-17,4,12
61260.0,1AB2733,1,1,1,1,2023-02-05,2023-03-24,0,47
61341.0,57407,8,8,8,8,2023-01-10,2023-02-01,0,22
61341.0,89400,10,10,1,1,2023-02-16,2023-03-13,0,25
61341.0,89400,10,10,7,7,2023-02-09,2023-03-13,0,32
61341.0,225012,2,2,2,2,2023-02-09,2023-03-13,0,32
61341.0,233023,1,1,1,1,2023-01-09,2023-02-09,0,31
61341.0,233023,1,1,1,1,2023-02-09,2023-03-13,0,32
61341.0,367012,2,2,1,1,2023-01-09,2023-02-09,0,31
61341.0,367012,2,2,2,2,2023-02-09,2023-03-13,0,32
61341.0,4520400,2,2,2,2,2023-01-09,2023-02-09,0,31
61341.0,4520400,4,4,2,2,2023-02-09,2023-03-13,0,32
61341.0,4907400,10,10,6,6,2023-02-09,2023-03-13,0,32
61341.0,5963336,12,12,12,12,2023-01-09,2023-02-16,0,38
61341.0,5963336,12,0,12,12,2023-01-09,2023-02-09,0,31
61341.0,5963336,12,12,12,12,2023-02-16,2023-03-13,0,25
61341.0,5963336,12,12,12,0,2023-02-09,2023-03-13,12,32
61341.0,5963336,12,12,12,0,2023-02-09,2023-02-16,12,7
61341.0,6179403,8,8,4,4,2023-02-09,2023-03-13,0,32
61341.0,6598405,8,0,6,6,2023-02-09,2023-03-13,0,32
61341.0,6968020,2,2,2,2,2023-02-09,2023-03-13,0,32
61341.0,1AA0003,1,1,1,1,2023-02-09,2023-03-13,0,32
61341.0,1AA0004,2,2,1,1,2023-01-09,2023-02-09,0,31
61341.0,1AA0004,2,2,2,2,2023-02-09,2023-03-13,0,32
61341.0,1AB2691,1,1,1,1,2023-02-09,2023-03-13,0,32
61426.0,725012,1,0,1,0,2023-03-10,2023-03-28,1,18
61426.0,799207,1,1,1,0,2023-03-10,2023-03-28,1,18
61426.0,9002072,1,0,1,0,2023-03-10,2023-03-28,1,18
61429.0,504010,1,1,1,0,2023-01-10,2023-01-11,1,1
61429.0,505018,2,2,2,0,2023-01-10,2023-01-11,2,1
61429.0,1412402,10,10,10,0,2023-01-10,2023-01-11,10,1
61515.0,24406,4,4,1,1,2023-02-22,2023-03-22,0,28
61515.0,91488,4,4,2,2,2023-02-22,2023-03-22,0,28
61515.0,8720790,5,5,3,3,2023-02-22,2023-03-22,0,28
61543.0,5406,4,4,2,2,2023-02-07,2023-03-22,0,43
61543.0,8720790,4,4,2,2,2023-02-07,2023-03-22,0,43
61587.0,5482401,15,15,8,8,2023-03-21,2023-03-29,0,8
61662.0,6598405,2,2,4,0,2023-01-16,2023-01-25,4,9
61703.0,571019,1,1,1,1,2023-01-10,2023-02-27,0,48
61705.0,62349,12,12,4,4,2022-12-07,2023-01-17,0,41
61705.0,1401405,18,0,4,4,2023-01-02,2023-02-17,0,46
61705.0,5482401,8,8,6,6,2022-12-07,2023-01-17,0,41
61705.0,5483409,2,2,2,0,2022-12-07,2022-12-16,2,9
61747.0,91488,6,6,4,4,2023-01-10,2023-01-23,0,13
61747.0,91488,6,6,4,4,2023-01-10,2023-02-23,0,44
61747.0,91488,4,4,4,0,2023-01-03,2023-01-10,4,7
61747.0,91488,6,6,4,0,2023-01-03,2023-01-23,4,20
61747.0,91488,6,6,4,0,2023-01-03,2023-02-23,4,51
61747.0,91488,6,6,6,6,2023-01-23,2023-02-23,0,31
61747.0,91488,6,6,6,6,2023-01-23,2023-03-22,0,58
61747.0,91488,6,6,6,6,2023-02-23,2023-03-22,0,27
61747.0,97403,3,3,3,3,2023-01-03,2023-01-23,0,20
61747.0,97403,3,3,3,3,2023-01-03,2023-02-23,0,51
61747.0,97403,3,3,3,3,2023-01-23,2023-02-23,0,31
61747.0,221010,1,1,1,1,2023-01-23,2023-02-23,0,31
61747.0,225012,2,2,2,0,2023-01-03,2023-01-10,2,7
61747.0,225012,1,1,2,0,2023-01-03,2023-01-23,2,20
61747.0,225012,1,1,2,0,2023-01-03,2023-02-23,2,51
61747.0,225012,1,1,1,1,2023-01-23,2023-02-23,0,31
61747.0,233023,1,1,1,1,2023-01-03,2023-01-23,0,20
61747.0,309170,1,1,1,1,2023-01-03,2023-01-23,0,20
61747.0,309170,1,1,1,1,2023-01-03,2023-02-23,0,51
61747.0,309170,1,1,1,1,2023-01-23,2023-02-23,0,31
61747.0,365016,1,1,1,1,2023-01-23,2023-02-23,0,31
61747.0,367012,2,2,2,2,2023-01-23,2023-02-23,0,31
61747.0,373019,1,1,1,1,2023-01-03,2023-01-23,0,20
61747.0,373019,1,1,1,1,2023-01-03,2023-02-23,0,51
61747.0,373019,1,1,1,1,2023-01-23,2023-02-23,0,31
61747.0,387028,2,2,2,2,2023-01-03,2023-01-23,0,20
61747.0,387036,1,1,1,1,2023-01-23,2023-02-23,0,31
61747.0,388018,1,1,1,1,2023-01-03,2023-01-23,0,20
61747.0,388018,1,1,1,1,2023-01-03,2023-02-23,0,51
61747.0,388018,1,1,1,1,2023-01-23,2023-02-23,0,31
61747.0,1676404,2,2,1,1,2023-02-03,2023-02-24,0,21
61747.0,1676404,2,2,1,1,2023-02-03,2023-03-22,0,47
61747.0,1676404,2,2,2,2,2023-02-24,2023-03-22,0,26
61747.0,2305135,6,6,3,3,2023-01-10,2023-01-23,0,13
61747.0,2305135,6,6,3,3,2023-01-10,2023-02-23,0,44
61747.0,2305135,6,6,6,6,2023-01-23,2023-02-23,0,31
61747.0,2305135,6,6,6,6,2023-01-23,2023-03-22,0,58
61747.0,2305135,3,3,3,3,2023-01-03,2023-01-10,0,7
61747.0,2305135,6,6,3,3,2023-01-03,2023-01-23,0,20
61747.0,2305135,6,6,3,3,2023-01-03,2023-02-23,0,51
61747.0,2305135,6,6,6,6,2023-02-23,2023-03-22,0,27
61747.0,4064408,4,4,2,2,2023-01-03,2023-01-23,0,20
61747.0,4226404,1,1,1,1,2023-01-23,2023-02-23,0,31
61747.0,4226404,2,2,1,1,2023-01-23,2023-03-22,0,58
61747.0,4226404,2,2,1,1,2023-02-23,2023-03-22,0,27
61747.0,4520400,2,2,1,1,2023-01-23,2023-02-23,0,31
61747.0,4520400,3,3,1,1,2023-01-23,2023-03-22,0,58
61747.0,4520400,1,1,1,1,2023-01-03,2023-01-23,0,20
61747.0,4520400,2,2,1,1,2023-01-03,2023-02-23,0,51
61747.0,4520400,3,3,2,2,2023-02-23,2023-03-22,0,27
61747.0,4907400,6,6,6,6,2023-01-23,2023-02-23,0,31
61747.0,4907400,6,6,4,0,2023-01-03,2023-01-23,4,20
61747.0,4907400,6,6,4,0,2023-01-03,2023-02-23,4,51
61747.0,5307401,2,0,1,0,2023-02-03,2023-02-24,1,21
61747.0,5307401,2,0,1,0,2023-02-03,2023-02-23,1,20
61747.0,5307401,2,0,1,0,2023-02-03,2023-03-22,1,47
61747.0,5307401,2,0,2,0,2023-02-24,2023-03-22,2,26
61747.0,5307401,1,0,1,0,2023-01-23,2023-02-03,1,11
61747.0,5307401,2,0,1,0,2023-01-23,2023-02-24,1,32
61747.0,5307401,2,0,1,0,2023-01-23,2023-02-23,1,31
61747.0,5307401,2,0,1,0,2023-01-23,2023-03-22,1,58
61747.0,5307401,2,0,2,0,2023-02-23,2023-02-24,2,1
61747.0,5307401,2,0,2,0,2023-02-23,2023-03-22,2,27
61747.0,5482401,16,16,14,14,2023-01-10,2023-01-23,0,13
61747.0,5482401,14,14,14,14,2023-01-10,2023-02-23,0,44
61747.0,5482401,14,14,14,0,2023-01-03,2023-01-10,14,7
61747.0,5482401,16,16,14,0,2023-01-03,2023-01-23,14,20
61747.0,5482401,14,14,14,0,2023-01-03,2023-02-23,14,51
61747.0,5963336,1,1,1,1,2023-01-23,2023-02-23,0,31
61747.0,5963336,1,1,1,1,2023-01-23,2023-03-22,0,58
61747.0,5963336,1,1,1,1,2023-02-23,2023-03-22,0,27
61747.0,6598405,10,10,7,7,2023-01-03,2023-01-23,0,20
61747.0,6598405,4,4,4,4,2023-02-23,2023-03-22,0,27
61747.0,6623400,8,8,5,5,2023-01-10,2023-01-23,0,13
61747.0,6623400,5,5,5,0,2023-01-03,2023-01-10,5,7
61747.0,6623400,8,8,5,0,2023-01-03,2023-01-23,5,20
61747.0,6623400,4,4,5,0,2023-01-03,2023-02-23,5,51
61747.0,6623400,4,4,4,4,2023-02-23,2023-03-22,0,27
61747.0,6968020,1,1,1,1,2023-01-03,2023-01-23,0,20
61747.0,6968038,1,1,1,1,2023-01-03,2023-01-23,0,20
61747.0,1AA0004,2,2,2,2,2023-01-23,2023-02-23,0,31
61747.0,1AA0004,2,2,2,2,2023-01-03,2023-01-23,0,20
61747.0,1AA0004,2,2,2,2,2023-01-03,2023-02-23,0,51
61754.0,11403,2,2,2,2,2023-01-27,2023-03-27,0,59
61783.0,97403,8,8,4,4,2023-01-23,2023-03-15,0,51
61783.0,829012,2,2,1,1,2023-02-09,2023-02-27,0,18
61783.0,5482401,8,8,1,1,2023-01-23,2023-03-15,0,51
61783.0,8720790,2,2,2,2,2023-01-23,2023-03-15,0,51
61783.0,1AB4571,2,2,10,0,2023-01-23,2023-03-15,10,51
61805.0,571019,1,1,1,0,2023-02-01,2023-02-13,1,12
61981.0,505018,3,3,2,0,2023-01-05,2023-01-23,2,18
61981.0,725012,1,1,1,0,2023-01-05,2023-01-23,1,18
61994.0,97403,7,7,6,6,2023-02-13,2023-03-13,0,28
61994.0,233023,1,1,1,1,2023-01-09,2023-02-13,0,35
61994.0,367012,2,2,2,2,2023-01-09,2023-02-13,0,35
61994.0,367012,2,2,2,2,2023-02-13,2023-03-13,0,28
61994.0,374025,1,1,1,1,2023-01-09,2023-02-13,0,35
61994.0,4907400,10,10,6,6,2023-01-09,2023-02-13,0,35
61994.0,5482401,9,9,4,4,2023-01-09,2023-02-13,0,35
61994.0,5482401,10,10,9,9,2023-02-13,2023-03-13,0,28
61994.0,6598405,4,4,4,4,2023-02-13,2023-03-13,0,28
61994.0,1AA0004,3,3,2,2,2023-01-09,2023-02-13,0,35
61994.0,1AB2691,4,4,2,2,2023-01-09,2023-02-13,0,35
62088.0,365016,2,2,2,2,2023-01-09,2023-01-10,0,1
62088.0,367012,2,2,2,2,2023-01-09,2023-01-10,0,1
62104.0,394106,1,1,1,0,2023-01-04,2023-02-28,1,55
62197.0,8688337,105,105,50,50,2022-12-09,2023-01-02,0,24
62198.0,8720774,3,3,3,0,2022-12-06,2023-01-10,3,35
62202.0,5406,2,2,2,0,2023-01-13,2023-01-17,2,4
62202.0,570094,1,1,1,0,2023-01-13,2023-01-17,1,4
62202.0,725012,1,1,1,0,2023-01-13,2023-01-17,1,4
62202.0,1105403,5,0,5,0,2023-01-13,2023-01-17,5,4
62202.0,2805101,8,0,8,0,2023-01-13,2023-01-17,8,4
62202.0,4520400,3,3,3,0,2023-01-13,2023-01-17,3,4
62202.0,6598405,2,2,2,0,2023-01-13,2023-01-17,2,4
62202.0,1AB5909,4,0,4,0,2023-01-13,2023-01-17,4,4
62223.0,1240407,2,2,2,2,2023-03-07,2023-03-27,0,20
62223.0,4520400,2,2,2,2,2023-03-07,2023-03-27,0,20
62223.0,5482401,4,4,3,3,2023-03-07,2023-03-27,0,20
62223.0,6598405,3,3,3,3,2023-03-07,2023-03-27,0,20
62223.0,6623400,3,3,3,3,2023-03-07,2023-03-27,0,20
62223.0,8720790,1,1,1,1,2023-03-07,2023-03-27,0,20
62229.0,6598405,11,11,6,6,2022-12-14,2023-01-24,0,41
62238.0,1628,1,1,1,0,2023-02-20,2023-03-16,1,24
62355.0,5406,6,6,4,4,2023-01-11,2023-01-12,0,1
62355.0,5406,4,4,10,0,2023-01-09,2023-01-11,10,2
62355.0,5406,6,6,10,0,2023-01-09,2023-01-12,10,3
62384.0,97403,4,4,2,2,2023-01-31,2023-03-20,0,48
62385.0,5482401,2,2,2,2,2022-12-19,2023-02-07,0,50
62385.0,9511404,6,6,2,2,2022-12-19,2023-02-07,0,50
62424.0,8720790,6,6,6,0,2023-01-10,2023-01-17,6,7
62475.0,387036,2,2,1,1,2022-12-28,2023-01-10,0,13
62475.0,387036,4,4,1,1,2022-12-28,2023-01-31,0,34
62475.0,387036,3,3,1,1,2022-12-28,2023-01-31,0,34
62475.0,387036,4,4,2,2,2023-01-10,2023-01-31,0,21
62475.0,387036,3,3,2,2,2023-01-10,2023-01-31,0,21
62480.0,51409,2,2,2,0,2023-01-15,2023-01-30,2,15
62480.0,9511404,2,2,2,0,2023-01-15,2023-01-30,2,15
62522.0,14407,10,10,4,4,2023-03-08,2023-03-28,0,20
62532.0,1402403,4,4,3,0,2023-01-12,2023-02-13,3,32
62546.0,24406,2,2,1,1,2023-01-19,2023-03-15,0,55
62546.0,1401405,2,2,2,2,2023-01-19,2023-03-15,0,55
62546.0,5482401,4,4,2,2,2023-01-19,2023-03-15,0,55
62546.0,6598405,2,2,2,2,2023-01-19,2023-03-15,0,55
62547.0,373019,2,2,2,0,2023-01-10,2023-02-02,2,23
62547.0,374025,1,1,1,0,2023-01-10,2023-02-02,1,23
62593.0,2101012,1,1,1,1,2023-01-16,2023-03-13,0,56
62593.0,2101020,1,1,1,1,2023-01-16,2023-03-13,0,56
62593.0,2101046,1,1,1,1,2023-01-16,2023-03-13,0,56
62624.0,5148409,2,2,2,2,2022-12-28,2023-02-26,0,60
62624.0,5482401,2,2,2,2,2022-12-28,2023-02-26,0,60
62640.0,2101012,1,1,1,1,2023-01-26,2023-03-13,0,46
62640.0,2101020,1,1,1,1,2023-01-26,2023-03-13,0,46
62640.0,2101046,1,1,1,1,2023-01-26,2023-03-13,0,46
62656.0,129503,1,1,1,0,2023-01-23,2023-02-09,1,17
62656.0,129511,1,1,1,0,2023-01-23,2023-02-09,1,17
62656.0,787012,3,3,3,0,2023-02-05,2023-02-09,3,4
62659.0,5406,6,6,6,0,2023-02-15,2023-03-01,6,14
62659.0,7402,1,1,1,0,2023-02-15,2023-03-01,1,14
62659.0,24406,4,4,4,0,2023-02-15,2023-03-01,4,14
62659.0,97403,20,20,20,0,2023-02-15,2023-03-01,20,14
62659.0,5482401,4,4,4,0,2023-02-15,2023-03-01,4,14
62659.0,8720790,2,0,2,2,2023-02-15,2023-03-01,0,14
62690.0,129503,2,2,2,0,2023-02-06,2023-02-24,2,18
62692.0,546012,1,0,1,0,2023-02-01,2023-02-28,1,27
62692.0,547010,1,1,1,0,2023-02-01,2023-02-28,1,27
62711.0,24406,4,4,3,0,2023-02-07,2023-03-14,3,35
62711.0,45626,4,4,4,0,2023-02-07,2023-03-14,4,35
62711.0,62349,4,4,3,0,2023-02-07,2023-03-14,3,35
62711.0,4608404,10,10,5,0,2023-02-07,2023-03-14,5,35
62711.0,5482401,2,2,1,1,2023-02-07,2023-03-14,0,35
62711.0,6598405,6,6,3,0,2023-02-07,2023-03-14,3,35
62711.0,8720790,3,0,3,0,2023-02-07,2023-03-14,3,35
62711.0,8720790,3,3,3,0,2023-02-07,2023-03-14,3,35
62711.0,1AB2190,1,1,1,0,2023-02-07,2023-03-14,1,35
62711.0,1AB2691,2,2,5,0,2023-02-07,2023-03-14,5,35
62726.0,309170,1,1,2,0,2023-01-16,2023-02-24,2,39
62726.0,367012,1,1,3,0,2023-01-16,2023-02-24,3,39
62726.0,8720790,3,3,13,0,2023-01-16,2023-02-24,13,39
62756.0,829012,1,1,1,1,2023-01-04,2023-01-31,0,27
62909.0,97403,2,2,2,0,2023-01-12,2023-02-02,2,21
62909.0,5482401,3,3,3,0,2023-01-12,2023-02-02,3,21
62939.0,1AB3456,4,4,4,0,2023-01-24,2023-02-20,4,27
62939.0,1AB3457,3,3,3,0,2023-01-24,2023-02-20,3,27
63004.0,504010,2,2,2,0,2023-01-25,2023-02-26,2,32
63004.0,505018,2,2,1,1,2023-01-25,2023-02-26,0,32
63074.0,97403,32,32,6,6,2023-03-22,2023-03-29,0,7
63099.0,504010,3,3,3,3,2023-01-09,2023-01-25,0,16
63099.0,505018,5,5,4,4,2023-01-09,2023-01-25,0,16
63102.0,8720774,6,6,6,0,2023-01-06,2023-01-26,6,20
63133.0,97403,1,1,1,1,2023-01-06,2023-02-20,0,45
63133.0,367012,1,1,1,1,2023-01-06,2023-02-20,0,45
63175.0,7402,2,2,2,0,2023-02-24,2023-03-07,2,11
63175.0,62349,2,2,2,0,2023-02-24,2023-03-07,2,11
63175.0,1401405,4,0,4,0,2023-02-24,2023-03-07,4,11
63175.0,6598405,3,3,3,0,2023-02-24,2023-03-07,3,11
63194.0,14407,3,3,2,2,2023-01-17,2023-03-17,0,59
63194.0,24406,3,3,2,2,2023-01-17,2023-03-17,0,59
63194.0,97403,3,3,2,2,2023-01-17,2023-03-17,0,59
63194.0,5482401,4,4,4,4,2023-01-17,2023-03-17,0,59
63204.0,373019,2,2,2,0,2023-02-02,2023-02-16,2,14
63204.0,388018,2,2,2,0,2023-02-02,2023-02-16,2,14
63245.0,16403,2,2,1,1,2023-01-10,2023-02-07,0,28
63245.0,5482401,4,4,2,2,2023-01-10,2023-02-07,0,28
63245.0,6623400,3,3,1,1,2023-01-10,2023-02-07,0,28
63249.0,721010,2,2,2,2,2023-01-16,2023-01-31,0,15
63249.0,723016,2,2,2,2,2023-01-16,2023-01-31,0,15
63249.0,4520400,2,2,1,1,2023-01-16,2023-01-31,0,15
63249.0,5482401,4,4,2,2,2023-01-16,2023-01-31,0,15
63252.0,6598405,6,6,2,2,2023-01-11,2023-02-13,0,33
63275.0,4608404,6,6,6,6,2022-12-19,2023-02-16,0,59
63275.0,8128770,1,0,1,0,2022-12-19,2023-01-30,1,42
63275.0,1AB3456,6,6,6,0,2022-12-19,2023-01-30,6,42
63280.0,5482401,8,8,1,1,2023-02-15,2023-03-02,0,15
63289.0,6598405,10,10,6,6,2023-01-10,2023-02-27,0,48
63289.0,6623400,10,10,6,6,2023-01-10,2023-02-27,0,48
63289.0,6623400,10,10,10,10,2023-02-27,2023-03-29,0,30
63291.0,51409,2,2,1,0,2023-01-03,2023-02-28,1,56
63291.0,367012,1,1,1,0,2023-01-03,2023-02-28,1,56
63291.0,1AA0004,1,1,1,1,2023-01-03,2023-02-28,0,56
63303.0,504010,2,2,2,2,2023-01-26,2023-03-07,0,40
63303.0,505018,4,0,4,4,2023-01-26,2023-03-07,0,40
63304.0,62349,2,2,1,0,2023-01-25,2023-03-13,1,47
63304.0,62349,2,2,1,1,2023-01-25,2023-03-13,0,47
63304.0,5482401,4,4,3,3,2023-01-25,2023-03-13,0,47
63312.0,374025,2,2,1,1,2023-02-23,2023-03-07,0,12
63320.0,364018,3,0,1,1,2023-02-16,2023-02-27,0,11
63337.0,8720774,9,0,2,2,2023-02-02,2023-02-23,0,21
63352.0,8720790,1,1,1,1,2023-01-04,2023-02-13,0,40
63352.0,1AB2190,2,0,2,0,2023-01-04,2023-02-13,2,40
63358.0,504010,2,2,2,0,2023-01-08,2023-01-13,2,5
63358.0,505018,4,4,4,0,2023-01-08,2023-01-13,4,5
63358.0,725012,1,1,1,0,2023-01-08,2023-01-13,1,5
63359.0,91488,4,4,4,4,2022-12-28,2023-01-26,0,29
63359.0,91488,4,4,4,4,2022-12-28,2023-02-20,0,54
63359.0,91488,4,4,4,4,2023-01-26,2023-02-20,0,25
63359.0,91488,4,4,4,4,2023-01-26,2023-03-22,0,55
63359.0,91488,4,4,4,4,2023-02-20,2023-03-22,0,30
63359.0,97403,10,10,2,2,2023-02-20,2023-03-22,0,30
63359.0,225012,1,1,1,1,2022-12-28,2023-01-26,0,29
63359.0,225012,1,1,1,1,2023-01-26,2023-03-22,0,55
63359.0,233023,3,3,1,1,2023-01-26,2023-02-20,0,25
63359.0,233023,3,3,1,1,2023-01-26,2023-03-22,0,55
63359.0,233023,3,3,3,3,2023-02-20,2023-03-22,0,30
63359.0,365016,1,1,1,1,2022-12-28,2023-02-20,0,54
63359.0,365016,1,1,1,1,2023-02-20,2023-03-22,0,30
63359.0,367012,2,2,2,2,2022-12-28,2023-01-26,0,29
63359.0,367012,4,4,2,2,2023-01-26,2023-03-22,0,55
63359.0,367012,4,4,1,1,2023-02-20,2023-03-22,0,30
63359.0,373019,2,2,1,1,2022-12-28,2023-01-26,0,29
63359.0,373019,2,2,2,2,2023-01-26,2023-03-22,0,55
63359.0,374025,1,1,1,1,2022-12-28,2023-02-20,0,54
63359.0,374025,1,1,1,1,2023-02-20,2023-03-22,0,30
63359.0,378019,1,1,1,1,2022-12-28,2023-02-20,0,54
63359.0,378019,3,3,1,1,2023-02-20,2023-03-22,0,30
63359.0,387036,2,2,1,1,2022-12-28,2023-01-26,0,29
63359.0,387036,1,1,1,1,2022-12-28,2023-02-20,0,54
63359.0,387036,2,2,2,2,2023-01-26,2023-03-22,0,55
63359.0,387036,2,2,1,1,2023-02-20,2023-03-22,0,30
63359.0,1676404,2,2,2,2,2023-01-27,2023-02-06,0,10
63359.0,1676404,4,4,2,2,2023-01-27,2023-03-03,0,35
63359.0,1676404,2,2,2,2,2023-01-27,2023-03-22,0,54
63359.0,1676404,4,4,2,2,2023-02-06,2023-03-03,0,25
63359.0,1676404,2,2,2,2,2023-02-06,2023-03-22,0,44
63359.0,2305135,10,10,10,0,2022-12-28,2023-01-06,10,9
63359.0,2305135,8,8,10,0,2022-12-28,2023-01-26,10,29
63359.0,2305135,8,8,10,0,2022-12-28,2023-02-20,10,54
63359.0,2305135,8,8,8,8,2023-01-26,2023-02-20,0,25
63359.0,4520400,1,1,1,1,2023-01-26,2023-02-20,0,25
63359.0,4520400,3,3,1,1,2023-01-26,2023-03-22,0,55
63359.0,4520400,3,3,1,1,2023-02-20,2023-03-22,0,30
63359.0,4907400,4,4,3,3,2023-01-26,2023-03-22,0,55
63359.0,4907400,4,4,1,1,2023-02-20,2023-03-22,0,30
63359.0,5307401,6,0,6,0,2022-12-28,2023-01-06,6,9
63359.0,5307401,6,0,6,0,2022-12-28,2023-01-20,6,23
63359.0,5307401,6,0,6,0,2022-12-28,2023-01-26,6,29
63359.0,5307401,1,0,6,0,2022-12-28,2023-02-20,6,54
63359.0,5307401,2,0,6,0,2022-12-28,2023-01-27,6,30
63359.0,5307401,6,0,6,0,2022-12-28,2023-02-06,6,40
63359.0,5307401,6,0,6,0,2023-01-06,2023-01-20,6,14
63359.0,5307401,6,0,6,0,2023-01-06,2023-01-26,6,20
63359.0,5307401,1,0,6,0,2023-01-06,2023-02-20,6,45
63359.0,5307401,2,0,6,0,2023-01-06,2023-01-27,6,21
63359.0,5307401,6,0,6,0,2023-01-06,2023-02-06,6,31
63359.0,5307401,6,0,6,0,2023-01-20,2023-01-26,6,6
63359.0,5307401,1,0,6,0,2023-01-20,2023-02-20,6,31
63359.0,5307401,2,0,6,0,2023-01-20,2023-01-27,6,7
63359.0,5307401,6,0,6,0,2023-01-20,2023-02-06,6,17
63359.0,5307401,1,0,6,0,2023-01-26,2023-02-20,6,25
63359.0,5307401,2,0,6,0,2023-01-26,2023-01-27,6,1
63359.0,5307401,6,0,6,0,2023-01-26,2023-02-06,6,11
63359.0,5307401,1,0,2,0,2023-01-27,2023-02-20,2,24
63359.0,5307401,6,0,2,0,2023-01-27,2023-02-06,2,10
63359.0,5307401,1,0,6,0,2023-02-06,2023-02-20,6,14
63359.0,5482401,6,6,2,2,2023-02-20,2023-03-22,0,30
63359.0,5963336,4,4,2,2,2023-01-26,2023-02-20,0,25
63359.0,5963336,2,2,2,2,2023-01-26,2023-03-22,0,55
63359.0,6598405,6,6,4,4,2023-01-26,2023-03-22,0,55
63359.0,6598405,6,6,2,2,2023-02-20,2023-03-22,0,30
63359.0,6623400,2,2,2,2,2022-12-28,2023-01-06,0,9
63359.0,6623400,3,3,1,1,2023-02-20,2023-03-22,0,30
63359.0,1AA0003,2,2,1,1,2023-02-20,2023-03-22,0,30
63359.0,1AA0004,2,2,1,1,2023-02-20,2023-03-22,0,30
63383.0,97403,3,3,3,3,2023-01-11,2023-01-30,0,19
63383.0,1105403,4,4,1,1,2023-01-11,2023-02-20,0,40
63414.0,1AB2190,1,1,1,0,2022-11-22,2023-01-11,1,50
63475.0,328097,2,2,2,2,2022-11-28,2023-01-05,0,38
63532.0,62349,4,4,4,0,2023-01-31,2023-02-03,4,3
63554.0,5406,2,2,3,0,2023-01-18,2023-01-19,3,1
63554.0,247016,3,0,3,0,2023-01-18,2023-01-19,3,1
63554.0,378019,1,0,2,0,2023-01-18,2023-01-19,2,1
63554.0,378019,1,1,2,0,2023-01-18,2023-01-19,2,1
63554.0,2101012,1,1,1,1,2023-01-19,2023-03-13,0,53
63554.0,2101020,1,1,1,1,2023-01-19,2023-03-13,0,53
63554.0,2101046,1,1,1,1,2023-01-19,2023-03-13,0,53
63554.0,6598405,3,3,3,0,2023-01-18,2023-01-19,3,1
63554.0,1AA9699,1,0,1,0,2023-01-18,2023-01-19,1,1
63554.0,1AB2735,1,1,4,0,2023-01-18,2023-01-19,4,1
63621.0,91488,8,8,2,2,2023-02-15,2023-02-22,0,7
63642.0,504010,1,1,1,0,2022-12-09,2023-01-06,1,28
63642.0,505018,3,3,3,0,2022-12-09,2023-01-06,3,28
63747.0,1105403,5,5,5,0,2023-02-08,2023-02-23,5,15
63747.0,1AA0004,4,4,4,0,2023-02-08,2023-02-23,4,15
63756.0,24406,2,2,2,0,2023-03-08,2023-03-09,2,1
63756.0,89400,1,1,1,0,2023-03-08,2023-03-09,1,1
63756.0,97403,4,4,4,0,2023-03-08,2023-03-09,4,1
63756.0,221010,1,0,1,0,2023-03-08,2023-03-09,1,1
63756.0,221010,1,1,1,0,2023-03-08,2023-03-09,1,1
63756.0,224014,1,0,1,0,2023-03-08,2023-03-09,1,1
63756.0,224014,1,1,1,0,2023-03-08,2023-03-09,1,1
63756.0,225012,1,0,1,0,2023-03-08,2023-03-09,1,1
63756.0,225012,1,1,1,0,2023-03-08,2023-03-09,1,1
63756.0,233023,1,0,1,0,2023-03-08,2023-03-09,1,1
63756.0,233023,1,1,1,0,2023-03-08,2023-03-09,1,1
63756.0,365016,2,0,2,0,2023-03-08,2023-03-09,2,1
63756.0,365016,2,2,2,0,2023-03-08,2023-03-09,2,1
63756.0,367012,1,1,1,0,2023-03-08,2023-03-09,1,1
63756.0,373019,2,2,2,0,2023-03-08,2023-03-09,2,1
63756.0,374025,1,1,1,0,2023-03-08,2023-03-09,1,1
63756.0,378019,1,1,1,0,2023-03-08,2023-03-09,1,1
63756.0,388018,1,0,1,0,2023-03-08,2023-03-09,1,1
63756.0,388018,1,1,1,0,2023-03-08,2023-03-09,1,1
63756.0,417015,1,0,1,0,2023-03-08,2023-03-09,1,1
63756.0,417015,1,1,1,0,2023-03-08,2023-03-09,1,1
63756.0,4064408,1,1,1,0,2023-03-08,2023-03-09,1,1
63756.0,4226404,2,2,2,0,2023-03-08,2023-03-09,2,1
63756.0,4520400,1,1,1,0,2023-03-08,2023-03-09,1,1
63756.0,5483409,1,1,1,0,2023-03-08,2023-03-09,1,1
63756.0,8717714,1,0,1,0,2023-03-08,2023-03-09,1,1
63756.0,9511404,1,1,1,0,2023-03-08,2023-03-09,1,1
63832.0,571019,1,1,1,1,2022-11-18,2022-12-16,0,28
63885.0,5406,4,4,4,4,2023-01-09,2023-01-19,0,10
63885.0,24406,3,3,3,3,2023-01-09,2023-01-19,0,10
63885.0,311191,3,3,3,3,2023-01-09,2023-01-19,0,10
63885.0,313197,2,2,2,2,2023-01-09,2023-01-19,0,10
63885.0,315094,2,2,2,2,2023-01-09,2023-01-19,0,10
63885.0,319195,2,2,2,2,2023-01-09,2023-01-19,0,10
63885.0,328097,1,1,1,1,2023-01-09,2023-01-19,0,10
63885.0,367012,1,1,1,1,2023-01-09,2023-01-19,0,10
63885.0,369026,2,2,2,2,2023-01-09,2023-01-19,0,10
63885.0,378019,2,2,2,2,2023-01-09,2023-01-19,0,10
63885.0,5482401,8,8,4,4,2023-01-09,2023-01-19,0,10
63885.0,8720790,2,2,2,2,2023-01-09,2023-01-19,0,10
63885.0,1AA0004,2,2,2,2,2023-01-09,2023-01-19,0,10
63898.0,225012,2,2,2,2,2023-01-10,2023-02-03,0,24
63898.0,367012,2,2,2,2,2023-01-10,2023-02-03,0,24
63898.0,367012,1,1,1,1,2023-03-07,2023-03-30,0,23
63898.0,1676404,8,8,8,8,2023-01-11,2023-03-03,0,51
63898.0,1676404,14,14,8,8,2023-01-11,2023-01-27,0,16
63898.0,1676404,10,0,8,8,2023-03-16,2023-03-30,0,14
63898.0,1676404,10,0,8,8,2023-03-03,2023-03-30,0,27
63898.0,1676404,8,8,8,8,2023-03-03,2023-03-16,0,13
63898.0,1676404,10,0,6,0,2023-03-07,2023-03-30,6,23
63898.0,1676404,8,8,6,0,2023-03-07,2023-03-16,6,9
63898.0,1677402,4,4,4,4,2022-12-01,2023-01-24,0,54
63898.0,5307401,16,0,4,0,2022-12-01,2022-12-14,4,13
63898.0,5307401,16,0,4,0,2022-12-01,2023-01-11,4,41
63898.0,5307401,14,0,4,0,2022-12-01,2023-01-27,4,57
63898.0,5307401,8,0,16,0,2022-12-14,2023-02-03,16,51
63898.0,5307401,16,0,16,0,2022-12-14,2023-01-11,16,28
63898.0,5307401,14,0,16,0,2022-12-14,2023-01-27,16,44
63898.0,5307401,8,0,16,0,2023-01-11,2023-02-03,16,23
63898.0,5307401,14,0,16,0,2023-01-11,2023-01-27,16,16
63898.0,5307401,8,0,14,0,2023-01-27,2023-02-03,14,7
63898.0,5482401,8,8,4,4,2023-02-03,2023-03-30,0,55
63898.0,5482401,5,5,4,4,2023-02-03,2023-03-07,0,32
63898.0,5482401,8,8,5,5,2023-03-07,2023-03-30,0,23
63898.0,6598405,10,10,4,4,2023-02-03,2023-03-30,0,55
63898.0,6598405,5,5,4,4,2023-02-03,2023-03-07,0,32
63898.0,6598405,10,10,5,5,2023-03-07,2023-03-30,0,23
63898.0,6623400,8,8,5,5,2023-02-03,2023-03-30,0,55
63898.0,6623400,8,8,5,5,2023-02-03,2023-03-07,0,32
63898.0,6623400,8,8,8,8,2023-01-10,2023-03-07,0,56
63898.0,6623400,8,8,8,8,2023-03-07,2023-03-30,0,23
63898.0,1AA0004,2,2,2,2,2023-02-03,2023-03-07,0,32
63898.0,1AA0004,2,2,2,2,2023-01-10,2023-02-03,0,24
63898.0,1AA0004,2,2,2,2,2023-01-10,2023-03-07,0,56
63908.0,91488,4,4,4,4,2022-12-24,2023-01-24,0,31
63908.0,91488,4,4,4,4,2023-01-24,2023-03-20,0,55
63908.0,221010,1,1,1,1,2022-12-24,2023-01-24,0,31
63908.0,225012,1,1,1,1,2022-12-24,2023-01-24,0,31
63908.0,233023,1,1,1,1,2022-12-24,2023-01-24,0,31
63908.0,309170,1,1,1,1,2022-12-24,2023-01-24,0,31
63908.0,365016,1,1,1,1,2022-12-24,2023-01-24,0,31
63908.0,367012,1,1,1,1,2022-12-24,2023-01-24,0,31
63908.0,373019,1,1,1,1,2022-12-24,2023-01-24,0,31
63908.0,374025,1,1,1,1,2022-12-24,2023-01-24,0,31
63908.0,378019,1,1,1,1,2022-12-24,2023-01-24,0,31
63908.0,387010,1,1,1,1,2022-12-24,2023-01-24,0,31
63908.0,387028,2,2,1,1,2022-12-24,2023-01-24,0,31
63908.0,387036,1,1,1,1,2022-12-24,2023-01-24,0,31
63908.0,388018,1,1,1,1,2022-12-24,2023-01-24,0,31
63908.0,2305135,6,6,6,6,2022-12-24,2023-01-24,0,31
63908.0,4064408,1,1,1,1,2022-12-24,2023-01-24,0,31
63908.0,4520400,1,1,1,1,2022-12-24,2023-01-24,0,31
63908.0,5307401,1,0,1,1,2022-12-24,2023-01-24,0,31
63908.0,5307401,1,0,1,1,2022-12-24,2023-01-27,0,34
63908.0,5307401,1,0,1,0,2023-01-24,2023-01-27,1,3
63908.0,5482401,14,14,14,14,2022-12-24,2023-01-24,0,31
63908.0,5482401,14,14,2,2,2023-01-12,2023-01-24,0,12
63908.0,6968020,1,1,1,1,2022-12-24,2023-01-24,0,31
63908.0,6968038,1,1,1,1,2022-12-24,2023-01-24,0,31
63908.0,1AA0003,1,1,1,1,2022-12-24,2023-01-24,0,31
63908.0,1AA0004,2,2,1,1,2022-12-24,2023-01-24,0,31
63912.0,5307401,2,0,2,0,2022-12-07,2023-01-31,2,55
63912.0,5307401,2,2,2,0,2023-01-31,2023-02-15,2,15
63912.0,8720774,3,3,3,0,2022-12-07,2023-01-31,3,55
63930.0,725012,2,2,1,0,2023-01-09,2023-01-10,1,1
63949.0,571019,2,2,2,0,2023-01-30,2023-02-07,2,8
63956.0,367012,1,1,1,0,2023-02-09,2023-03-14,1,33
63969.0,33332,12,12,8,8,2023-01-19,2023-03-06,0,46
64008.0,504010,3,3,1,1,2023-02-02,2023-03-07,0,33
64008.0,504010,2,0,1,1,2023-02-02,2023-03-07,0,33
64008.0,505018,6,6,2,2,2023-02-02,2023-03-07,0,33
64008.0,505018,4,0,2,2,2023-02-02,2023-03-07,0,33
64065.0,97403,6,6,4,4,2023-01-08,2023-03-01,0,52
64069.0,91488,6,6,5,5,2022-12-01,2023-01-10,0,40
64069.0,91488,8,8,6,6,2023-01-10,2023-02-21,0,42
64069.0,91488,6,6,6,6,2023-01-10,2023-02-28,0,49
64104.0,8111742,1,1,1,0,2022-11-16,2022-11-21,1,5
64123.0,5482401,3,3,6,0,2023-01-10,2023-02-27,6,48
64187.0,5148409,15,15,10,10,2023-02-02,2023-03-16,0,42
64187.0,5148409,10,10,10,10,2023-01-10,2023-02-02,0,23
64197.0,882085,1,1,1,0,2023-01-18,2023-03-06,1,47
64202.0,504010,1,1,1,1,2022-12-28,2023-01-06,0,9
64202.0,505018,3,3,2,2,2022-12-28,2023-01-06,0,9
64211.0,24406,2,2,1,0,2023-01-11,2023-03-06,1,54
64211.0,5482401,5,5,2,2,2023-01-11,2023-03-06,0,54
64211.0,8720790,2,2,2,0,2023-01-11,2023-03-06,2,54
64218.0,8688337,10,10,10,10,2023-02-21,2023-03-13,0,20
64232.0,504010,5,5,1,1,2023-02-05,2023-03-07,0,30
64232.0,504010,1,1,1,1,2023-01-04,2023-02-05,0,32
64232.0,505018,10,10,1,1,2023-02-05,2023-03-07,0,30
64277.0,91488,10,10,8,8,2023-02-01,2023-03-20,0,47
64296.0,14407,2,2,2,2,2023-01-11,2023-02-22,0,42
64350.0,504010,1,1,1,1,2023-01-27,2023-02-03,0,7
64350.0,505018,3,3,2,2,2023-01-27,2023-02-03,0,7
64384.0,97403,2,2,2,0,2023-02-09,2023-02-11,2,2
64384.0,1AA0004,2,2,2,0,2023-02-09,2023-02-11,2,2
64390.0,725012,1,1,1,1,2023-01-15,2023-01-17,0,2
64407.0,24406,4,4,4,0,2023-02-15,2023-02-20,4,5
64407.0,62349,2,2,2,0,2023-02-15,2023-02-20,2,5
64407.0,91488,30,30,10,10,2023-02-15,2023-02-20,0,5
64407.0,5482401,4,4,4,0,2023-02-15,2023-02-20,4,5
64407.0,8720790,5,5,5,0,2023-02-15,2023-02-20,5,5
64412.0,365016,1,1,1,1,2023-02-21,2023-02-27,0,6
64412.0,373019,2,2,2,0,2023-02-21,2023-02-27,2,6
64412.0,388018,1,1,1,1,2023-02-21,2023-02-27,0,6
64439.0,2305135,16,16,4,4,2023-01-10,2023-01-16,0,6
64444.0,5482401,8,8,2,2,2023-01-27,2023-03-09,0,41
64469.0,5482401,5,5,2,2,2023-01-12,2023-02-13,0,32
64501.0,8720790,4,4,4,4,2023-02-01,2023-03-21,0,48
64509.0,247016,1,1,2,0,2023-01-04,2023-01-09,2,5
64509.0,247016,1,1,2,0,2023-01-04,2023-01-09,2,5
64509.0,311019,1,1,2,0,2023-01-04,2023-01-09,2,5
64509.0,313197,1,1,3,0,2023-01-04,2023-01-09,3,5
64509.0,315094,2,2,1,0,2023-01-04,2023-01-09,1,5
64509.0,364018,1,1,1,0,2023-01-04,2023-01-09,1,5
64509.0,367012,2,2,2,0,2023-01-04,2023-01-09,2,5
64509.0,367012,2,2,2,0,2023-01-04,2023-01-09,2,5
64509.0,374025,1,1,3,0,2023-01-04,2023-01-09,3,5
64509.0,378019,1,1,2,0,2023-01-04,2023-01-09,2,5
64509.0,378019,1,1,2,0,2023-01-04,2023-01-09,2,5
64509.0,378019,1,1,2,0,2023-01-04,2023-01-09,2,5
64509.0,378019,1,1,2,0,2023-01-04,2023-01-09,2,5
64509.0,6598405,8,8,8,0,2023-01-04,2023-01-09,8,5
64528.0,2305135,35,35,2,2,2022-12-19,2023-01-11,0,23
64534.0,387010,3,3,2,2,2023-02-27,2023-03-02,0,3
64534.0,5480405,5,5,5,5,2023-02-02,2023-02-24,0,22
64534.0,5480405,5,5,5,5,2023-01-09,2023-02-02,0,24
64534.0,5480405,5,5,5,5,2023-01-09,2023-02-24,0,46
64536.0,5482401,5,0,4,4,2023-02-07,2023-03-07,0,28
64618.0,8740012,8,8,8,0,2023-02-02,2023-02-22,8,20
64618.0,8740012,10,10,8,0,2023-02-02,2023-02-27,8,25
64618.0,8740012,10,10,8,8,2023-02-22,2023-02-27,0,5
64654.0,14407,6,6,4,4,2023-01-09,2023-03-03,0,53
64759.0,8720790,2,2,2,2,2023-02-08,2023-02-15,0,7
64791.0,24406,1,1,1,1,2023-01-06,2023-03-03,0,56
64791.0,4520400,1,1,1,1,2023-01-06,2023-03-03,0,56
64791.0,8720790,5,5,5,5,2023-01-06,2023-03-03,0,56
64791.0,8740012,4,0,1,1,2023-01-06,2023-03-03,0,56
64794.0,658031,1,1,1,0,2023-01-06,2023-01-26,1,20
64794.0,700014,1,1,1,0,2023-01-06,2023-01-26,1,20
64989.0,6979407,2,2,2,0,2023-01-26,2023-02-09,2,14
65035.0,62349,5,5,5,5,2023-03-05,2023-03-08,0,3
65038.0,5482401,4,4,2,2,2023-01-23,2023-02-15,0,23
65038.0,1AB2919,4,4,3,3,2023-01-23,2023-02-15,0,23
65112.0,62349,2,2,1,0,2023-01-24,2023-01-31,1,7
65112.0,62349,2,2,1,0,2023-01-24,2023-01-31,1,7
65148.0,6625331,56,56,50,50,2023-01-04,2023-01-09,0,5
65170.0,367012,3,0,2,0,2023-01-18,2023-03-05,2,46
65170.0,367012,3,3,2,0,2023-01-18,2023-03-05,2,46
65170.0,8720790,3,0,3,0,2023-01-18,2023-03-05,3,46
65170.0,8720790,3,3,3,0,2023-01-18,2023-03-05,3,46
65193.0,1AA0004,2,2,2,0,2023-01-25,2023-02-02,2,8
65194.0,5406,4,4,4,4,2022-11-21,2023-01-04,0,44
65194.0,97403,16,16,6,6,2022-11-21,2023-01-04,0,44
65194.0,6598405,12,12,4,4,2022-11-21,2023-01-04,0,44
65195.0,504010,3,3,1,1,2022-11-25,2023-01-11,0,47
65195.0,505018,2,2,2,2,2022-11-25,2023-01-11,0,47
65195.0,571019,4,0,3,0,2022-11-25,2023-01-11,3,47
65195.0,571415,1,1,3,0,2022-11-25,2023-01-11,3,47
65204.0,571019,1,1,1,0,2023-02-16,2023-03-03,1,15
65208.0,373019,2,2,2,0,2023-02-14,2023-02-20,2,6
65213.0,16403,3,3,3,0,2023-02-02,2023-02-28,3,26
65213.0,173062,1,1,1,0,2023-02-02,2023-02-28,1,26
65213.0,247016,3,3,3,0,2023-02-02,2023-02-28,3,26
65213.0,374025,1,1,1,1,2023-02-02,2023-02-28,0,26
65213.0,6968020,1,1,1,0,2023-02-02,2023-02-28,1,26
65213.0,6968038,1,1,1,0,2023-02-02,2023-02-28,1,26
65213.0,8720774,3,3,6,0,2023-02-02,2023-03-07,6,33
65213.0,8720774,3,3,6,0,2023-02-02,2023-02-28,6,26
65213.0,8720774,3,3,3,3,2023-02-28,2023-03-07,0,7
65213.0,1AB2919,2,2,2,0,2023-02-28,2023-03-07,2,7
65213.0,1AB3459,2,2,2,0,2023-02-02,2023-03-07,2,33
65213.0,1AB3459,2,0,2,0,2023-02-02,2023-02-28,2,26
65213.0,1AB3459,2,2,2,0,2023-02-28,2023-03-07,2,7
65213.0,1AB3465,1,1,1,0,2023-02-02,2023-03-07,1,33
65213.0,1AB3465,1,0,1,0,2023-02-02,2023-02-28,1,26
65213.0,1AB3465,1,1,1,0,2023-02-28,2023-03-07,1,7
65213.0,1AB6127,3,0,3,0,2023-02-02,2023-03-07,3,33
65213.0,1AB6127,3,0,3,0,2023-02-02,2023-02-28,3,26
65213.0,1AB6127,3,0,3,0,2023-02-28,2023-03-07,3,7
65213.0,1AB6128,1,1,1,0,2023-02-02,2023-03-07,1,33
65213.0,1AB6128,1,0,1,0,2023-02-02,2023-02-28,1,26
65213.0,1AB6128,1,1,1,0,2023-02-28,2023-03-07,1,7
65248.0,107012,1,1,1,0,2022-12-08,2022-12-22,1,14
65248.0,387028,2,2,1,1,2022-12-08,2022-12-22,0,14
65248.0,6598405,10,10,5,5,2022-12-08,2022-12-22,0,14
65287.0,4226404,1,1,5,0,2023-01-09,2023-02-19,5,41
65288.0,97403,4,4,3,3,2023-01-15,2023-03-08,0,52
65288.0,504010,2,2,2,2,2023-01-15,2023-03-08,0,52
65288.0,5483409,4,4,2,2,2023-01-15,2023-03-08,0,52
65297.0,91488,3,3,3,0,2023-01-09,2023-01-16,3,7
65297.0,97403,6,6,6,0,2023-01-09,2023-01-16,6,7
65297.0,5483409,4,4,4,0,2023-01-09,2023-01-16,4,7
65302.0,9511404,2,2,1,1,2023-01-16,2023-02-10,0,25
65302.0,1AB2919,3,3,1,1,2023-01-16,2023-02-10,0,25
65374.0,8720774,1,1,1,0,2023-01-12,2023-01-25,1,13
65390.0,129503,2,0,2,0,2023-02-21,2023-02-22,2,1
65390.0,129529,1,0,1,0,2023-02-21,2023-02-22,1,1
65390.0,365016,4,4,4,0,2023-02-21,2023-03-02,4,9
65390.0,373019,2,2,2,0,2023-02-21,2023-03-02,2,9
65390.0,373019,2,2,3,0,2023-02-21,2023-03-02,3,9
65390.0,388018,4,4,4,0,2023-02-21,2023-03-02,4,9
65390.0,584012,1,1,1,0,2023-02-21,2023-02-22,1,1
65390.0,631060,3,3,3,0,2023-02-21,2023-02-22,3,1
65390.0,698029,1,1,1,0,2023-02-21,2023-02-22,1,1
65390.0,699027,1,1,1,0,2023-02-21,2023-02-22,1,1
65390.0,700014,1,1,1,0,2023-02-21,2023-02-22,1,1
65390.0,704024,1,0,1,0,2023-02-21,2023-02-22,1,1
65390.0,716011,1,1,1,0,2023-02-21,2023-02-22,1,1
65390.0,717019,1,1,1,0,2023-02-21,2023-02-22,1,1
65390.0,725012,2,0,2,2,2023-02-21,2023-02-22,0,1
65390.0,994054,1,0,1,0,2023-02-21,2023-02-22,1,1
65390.0,995128,1,1,1,0,2023-02-21,2023-02-22,1,1
65390.0,9037053,1,1,1,1,2023-02-21,2023-02-22,0,1
65390.0,9039059,1,1,1,0,2023-02-21,2023-02-22,1,1
65390.0,9076044,3,0,1,1,2023-02-21,2023-02-22,0,1
65390.0,9076051,2,0,2,0,2023-02-22,2023-03-02,2,8
65390.0,9076051,2,0,2,2,2023-02-21,2023-03-02,0,9
65390.0,9076051,2,0,2,2,2023-02-21,2023-02-22,0,1
65398.0,1105403,5,5,5,0,2022-11-30,2022-12-07,5,7
65398.0,1402403,4,4,4,0,2022-11-30,2022-12-07,4,7
65411.0,367012,1,1,1,0,2023-01-10,2023-03-08,1,57
65411.0,367012,1,1,1,1,2023-01-10,2023-03-08,0,57
65411.0,378019,1,1,1,0,2023-01-10,2023-03-08,1,57
65411.0,378019,1,1,1,1,2023-01-10,2023-03-08,0,57
65411.0,387028,1,1,1,0,2023-01-10,2023-03-08,1,57
65411.0,387028,1,1,1,1,2023-01-10,2023-03-08,0,57
65411.0,1AA0004,1,1,1,0,2023-01-10,2023-03-08,1,57
65411.0,1AA0004,1,1,1,1,2023-01-10,2023-03-08,0,57
65413.0,129511,1,1,1,0,2022-11-21,2023-01-10,1,50
65413.0,658031,1,1,1,0,2022-11-21,2023-01-10,1,50
65413.0,882077,1,0,1,0,2022-11-21,2023-01-10,1,50
65418.0,1412402,6,6,4,4,2022-12-20,2023-02-01,0,43
65461.0,388018,1,1,1,0,2023-01-09,2023-01-12,1,3
65461.0,6179403,1,1,4,0,2023-01-09,2023-02-21,4,43
65461.0,6179403,1,0,4,0,2023-01-09,2023-01-12,4,3
65461.0,6179403,1,0,4,0,2023-01-09,2023-01-12,4,3
65461.0,6179403,3,0,4,0,2023-01-09,2023-01-12,4,3
65461.0,6179403,4,4,4,0,2023-01-09,2023-01-12,4,3
65461.0,6179403,1,1,1,0,2023-01-12,2023-02-21,1,40
65461.0,6179403,1,1,1,0,2023-01-12,2023-02-21,1,40
65461.0,6179403,1,1,3,0,2023-01-12,2023-02-21,3,40
65464.0,91488,2,2,1,1,2022-12-29,2023-01-16,0,18
65464.0,388018,1,1,1,0,2022-12-29,2023-01-16,1,18
65464.0,388018,1,1,2,0,2022-12-29,2023-01-16,2,18
65464.0,725012,2,2,1,1,2022-12-29,2023-01-16,0,18
65464.0,1AA0003,2,2,1,1,2022-12-29,2023-01-16,0,18
65469.0,820028,1,1,1,1,2023-02-02,2023-02-07,0,5
65493.0,233023,2,2,1,1,2023-02-14,2023-02-27,0,13
65514.0,614017,1,1,1,0,2023-01-03,2023-01-04,1,1
65518.0,129503,1,1,1,0,2022-11-09,2022-12-09,1,30
65518.0,129511,1,1,1,0,2022-11-09,2022-12-09,1,30
65518.0,388018,1,1,1,0,2022-11-09,2023-01-03,1,55
65518.0,617011,1,1,1,0,2022-11-09,2022-12-09,1,30
65518.0,655011,1,1,1,0,2022-11-09,2022-12-09,1,30
65518.0,658023,1,0,1,0,2022-11-09,2022-12-09,1,30
65518.0,700014,1,1,1,0,2022-11-09,2022-12-09,1,30
65518.0,701012,1,1,1,0,2022-11-09,2022-12-09,1,30
65518.0,702010,1,1,1,0,2022-11-09,2022-12-09,1,30
65518.0,739013,1,1,1,0,2022-11-09,2022-12-09,1,30
65518.0,783010,1,1,1,0,2022-11-09,2022-12-09,1,30
65518.0,787012,1,1,1,0,2022-11-09,2022-12-09,1,30
65518.0,820028,1,0,1,0,2022-11-09,2022-12-09,1,30
65518.0,9076010,1,0,1,0,2022-11-09,2022-12-09,1,30
65518.0,9076028,1,0,1,0,2022-11-09,2022-12-09,1,30
65518.0,9076036,1,0,1,0,2022-11-09,2022-12-09,1,30
65531.0,8688337,10,10,10,0,2023-03-02,2023-03-09,10,7
65531.0,1AA7984,3,3,3,0,2023-03-02,2023-03-09,3,7
65531.0,1AA7986,2,0,2,0,2023-03-09,2023-03-15,2,6
65531.0,1AA8981,1,1,1,0,2023-03-09,2023-03-15,1,6
65531.0,1AA8981,1,0,1,0,2023-03-02,2023-03-09,1,7
65531.0,1AA8981,1,1,1,0,2023-03-02,2023-03-15,1,13
65531.0,1AA8987,1,1,1,0,2023-03-02,2023-03-09,1,7
65531.0,1AA9008,1,1,1,0,2023-03-02,2023-03-09,1,7
65531.0,1AB5495,5,5,5,0,2023-03-09,2023-03-15,5,6
65531.0,1AB5495,5,0,5,0,2023-03-02,2023-03-09,5,7
65531.0,1AB5495,5,5,5,0,2023-03-02,2023-03-15,5,13
65531.0,1AB5497,2,2,2,0,2023-03-09,2023-03-15,2,6
65531.0,1AB5497,2,0,2,0,2023-03-02,2023-03-09,2,7
65531.0,1AB5497,2,2,2,0,2023-03-02,2023-03-15,2,13
65531.0,1AB5499,3,3,3,0,2023-03-02,2023-03-09,3,7
65531.0,1AB6179,4,4,4,0,2023-03-02,2023-03-09,4,7
65531.0,1AB6180,2,2,2,0,2023-03-02,2023-03-09,2,7
65549.0,515017,1,1,1,0,2022-11-19,2023-01-03,1,45
65549.0,792011,1,1,1,0,2022-11-19,2023-01-03,1,45
65549.0,816027,2,0,1,1,2022-11-19,2023-01-03,0,45
65554.0,5148409,20,20,20,20,2023-02-22,2023-03-02,0,8
65554.0,5148409,20,20,20,20,2023-02-02,2023-03-02,0,28
65554.0,5148409,20,20,20,20,2023-02-02,2023-02-22,0,20
65575.0,9806011,1,1,1,0,2023-01-20,2023-01-30,1,10
65575.0,9809015,2,2,3,0,2023-01-20,2023-01-30,3,10
65607.0,26402,6,0,6,0,2023-01-16,2023-01-18,6,2
65607.0,97403,8,8,8,0,2023-01-18,2023-02-01,8,14
65607.0,97403,8,8,8,0,2023-01-16,2023-02-01,8,16
65607.0,97403,8,0,8,0,2023-01-16,2023-01-18,8,2
65607.0,309170,2,2,2,0,2023-01-16,2023-02-01,2,16
65607.0,367012,2,2,2,0,2023-01-18,2023-02-01,2,14
65607.0,367012,2,2,2,0,2023-01-16,2023-02-01,2,16
65607.0,367012,2,0,2,0,2023-01-16,2023-01-18,2,2
65607.0,4520400,3,3,1,1,2023-01-18,2023-02-01,0,14
65607.0,4520400,3,3,2,2,2023-01-16,2023-02-01,0,16
65607.0,5482401,10,10,10,0,2023-01-16,2023-01-18,10,2
65607.0,6598405,8,8,8,0,2023-01-16,2023-01-18,8,2
65607.0,6623400,6,6,6,0,2023-01-16,2023-01-18,6,2
65607.0,6968020,1,1,1,0,2023-01-16,2023-02-01,1,16
65607.0,6968038,1,1,1,0,2023-01-16,2023-02-01,1,16
65609.0,4520400,4,4,4,0,2023-01-09,2023-01-10,4,1
65609.0,6623400,6,6,6,0,2023-01-09,2023-01-10,6,1
65614.0,8740012,2,2,2,0,2023-01-16,2023-02-24,2,39
65624.0,658023,1,0,1,0,2023-01-04,2023-02-01,1,28
65624.0,882044,1,0,1,0,2023-01-04,2023-02-01,1,28
65624.0,1105403,10,10,4,4,2023-01-04,2023-02-21,0,48
65624.0,1402403,2,2,4,0,2023-01-04,2023-02-21,4,48
65624.0,9076051,1,1,1,0,2023-01-04,2023-02-01,1,28
65642.0,1AB1973,1,1,1,0,2022-11-02,2022-11-21,1,19
65653.0,367012,1,1,1,1,2023-01-20,2023-03-07,0,46
65653.0,373019,1,1,1,1,2023-01-20,2023-03-07,0,46
65674.0,504010,2,0,2,0,2023-02-09,2023-02-10,2,1
65674.0,505018,4,4,4,0,2023-02-09,2023-02-10,4,1
65674.0,571019,1,1,1,0,2023-02-09,2023-02-10,1,1
65674.0,725012,1,1,1,0,2023-02-09,2023-02-10,1,1
65680.0,369018,1,1,1,0,2023-01-09,2023-01-31,1,22
65680.0,369018,1,1,1,0,2023-01-09,2023-01-31,1,22
65680.0,1AA0003,1,1,1,0,2023-01-09,2023-01-31,1,22
65680.0,1AA0003,1,1,1,0,2023-01-09,2023-01-31,1,22
65680.0,1AA0004,1,1,1,0,2023-01-09,2023-01-31,1,22
65691.0,14407,24,24,24,0,2023-01-17,2023-01-31,24,14
65691.0,97403,40,40,40,0,2023-01-17,2023-01-31,40,14
65691.0,3014958,30,0,10,0,2023-01-17,2023-02-14,10,28
65695.0,1AB4571,60,60,3,3,2023-02-03,2023-03-13,0,38
65711.0,1AA0003,1,0,1,1,2023-01-17,2023-02-28,0,42
65711.0,1AA0004,3,3,1,1,2023-01-17,2023-02-28,0,42
65715.0,365016,1,1,1,0,2023-01-17,2023-03-07,1,49
65715.0,2256106,1,1,1,0,2023-01-17,2023-03-07,1,49
65784.0,98401,16,16,14,14,2023-02-05,2023-02-20,0,15
65784.0,2101012,1,1,1,0,2023-02-05,2023-02-08,1,3
65784.0,2101020,1,1,1,0,2023-02-05,2023-02-08,1,3
65789.0,655011,1,1,1,0,2023-01-18,2023-02-10,1,23
65821.0,571415,1,0,1,0,2023-02-21,2023-03-22,1,29
65828.0,5406,4,4,4,0,2023-02-23,2023-02-24,4,1
65828.0,365016,1,1,1,0,2023-02-23,2023-02-24,1,1
65828.0,829053,1,1,1,0,2023-02-23,2023-02-24,1,1
65828.0,1401405,3,3,2,0,2023-02-23,2023-03-03,2,8
65828.0,1AA0003,1,1,1,0,2023-02-23,2023-02-24,1,1
65828.0,1AA0003,1,1,1,0,2023-02-23,2023-03-03,1,8
65828.0,1AA0003,1,1,1,1,2023-02-24,2023-03-03,0,7
65844.0,162016,1,1,1,0,2023-02-07,2023-02-27,1,20
65844.0,367012,1,1,1,0,2023-02-07,2023-02-27,1,20
65844.0,373019,1,1,1,0,2023-02-07,2023-02-27,1,20
65844.0,387010,1,1,1,0,2023-02-07,2023-02-27,1,20
65844.0,388018,1,1,1,0,2023-02-07,2023-02-27,1,20
65844.0,504010,2,2,2,0,2023-02-07,2023-02-27,2,20
65844.0,505018,4,4,4,0,2023-02-07,2023-02-27,4,20
65844.0,571019,2,2,2,0,2023-02-07,2023-02-27,2,20
65844.0,725012,2,2,2,0,2023-02-07,2023-02-27,2,20
65844.0,1AA0003,1,1,1,0,2023-02-07,2023-02-27,1,20
65849.0,614017,1,1,1,0,2023-02-21,2023-02-24,1,3
65849.0,616013,1,1,1,0,2023-02-21,2023-02-24,1,3
65849.0,618019,1,1,1,0,2023-02-21,2023-02-24,1,3
65889.0,14407,25,25,16,16,2023-03-06,2023-03-08,0,2
65889.0,221010,2,2,1,1,2023-03-06,2023-03-08,0,2
65889.0,225012,1,1,1,1,2023-03-06,2023-03-08,0,2
65889.0,367012,2,2,2,2,2023-03-06,2023-03-08,0,2
65889.0,369018,1,1,1,1,2023-03-06,2023-03-08,0,2
65889.0,369026,5,5,3,3,2023-03-06,2023-03-08,0,2
65889.0,373019,2,2,2,2,2023-03-06,2023-03-08,0,2
65889.0,388018,2,2,2,2,2023-03-06,2023-03-08,0,2
65889.0,655011,1,1,1,1,2023-03-06,2023-03-08,0,2
65889.0,1AA0003,1,1,1,1,2023-03-06,2023-03-08,0,2
65889.0,1AA0004,5,5,3,3,2023-03-06,2023-03-08,0,2
65889.0,1AB1973,1,1,1,1,2023-03-06,2023-03-08,0,2
65913.0,1AB2738,1,1,1,1,2023-03-07,2023-03-28,0,21
65913.0,1AB2740,1,0,1,0,2023-03-07,2023-03-28,1,21
65913.0,1AB2807,1,0,1,1,2023-03-07,2023-03-28,0,21
90692.0,34405,3,3,1,1,2022-11-28,2022-12-08,0,10
90692.0,34405,1,1,1,1,2022-11-28,2023-01-11,0,44
90692.0,34405,3,3,1,1,2023-01-11,2023-02-08,0,28
90692.0,367012,1,1,1,0,2023-02-08,2023-02-22,1,14
90692.0,6675401,1,1,1,1,2023-01-14,2023-02-14,0,31
91394.0,4941408,20,20,18,18,2023-01-17,2023-02-03,0,17
91394.0,4941408,30,30,18,18,2023-01-17,2023-03-13,0,55
91394.0,4941408,39,39,18,18,2023-01-17,2023-03-15,0,57
91394.0,4941408,30,30,20,20,2023-02-03,2023-03-13,0,38
91394.0,4941408,39,39,20,20,2023-02-03,2023-03-15,0,40
91394.0,4941408,39,39,30,30,2023-03-13,2023-03-15,0,2
94365.0,5482401,16,16,5,5,2023-01-20,2023-03-09,0,48
94412.0,5406,6,6,3,3,2023-01-23,2023-01-31,0,8
94412.0,36401,2,2,2,2,2022-12-27,2023-01-23,0,27
94412.0,36401,7,7,2,2,2023-01-23,2023-03-17,0,53
94412.0,60400,1,1,1,1,2023-01-23,2023-03-17,0,53
94412.0,62349,4,4,4,4,2022-12-27,2023-01-31,0,35
94412.0,62349,5,5,4,4,2023-01-31,2023-03-17,0,45
94412.0,63404,7,7,4,4,2023-01-31,2023-03-17,0,45
94412.0,82404,3,3,3,3,2022-12-27,2023-01-23,0,27
94412.0,82404,13,13,3,3,2023-01-23,2023-03-17,0,53
94412.0,89400,3,3,1,1,2023-01-23,2023-01-31,0,8
94412.0,89400,2,2,1,1,2023-01-23,2023-03-17,0,53
94412.0,91488,15,15,2,2,2023-01-23,2023-03-17,0,53
94412.0,91488,15,15,1,1,2023-01-31,2023-03-17,0,45
94412.0,97403,1,1,1,1,2023-01-23,2023-01-31,0,8
94412.0,97403,5,5,1,1,2023-01-23,2023-03-17,0,53
94412.0,97403,5,5,1,1,2023-01-31,2023-03-17,0,45
94412.0,388018,2,2,1,1,2023-01-31,2023-03-17,0,45
94412.0,4064408,8,8,5,5,2023-01-23,2023-03-17,0,53
94412.0,4064408,8,8,1,1,2023-01-31,2023-03-17,0,45
94412.0,4520400,3,3,2,2,2023-01-31,2023-03-17,0,45
94412.0,4608404,5,5,2,2,2022-12-27,2023-01-31,0,35
94412.0,4608404,9,9,5,5,2023-01-31,2023-03-17,0,45
94412.0,4757409,2,2,2,2,2022-12-27,2023-01-23,0,27
94412.0,4757409,14,14,2,2,2022-12-27,2023-01-31,0,35
94412.0,4757409,14,14,2,2,2023-01-23,2023-01-31,0,8
94412.0,4757409,26,26,2,2,2023-01-23,2023-03-17,0,53
94412.0,4757409,26,26,14,14,2023-01-31,2023-03-17,0,45
94412.0,5148409,2,2,2,2,2023-01-23,2023-01-31,0,8
94412.0,6598405,9,9,9,9,2022-12-27,2023-01-23,0,27
94412.0,6598405,9,9,9,9,2022-12-27,2023-01-31,0,35
94412.0,6598405,9,9,9,9,2023-01-23,2023-01-31,0,8
94412.0,8740012,13,13,10,10,2022-12-27,2023-01-31,0,35
94412.0,1AB2733,2,2,1,1,2023-01-31,2023-03-17,0,45
94412.0,1AB2919,12,12,6,6,2023-01-31,2023-03-17,0,45
94428.0,374025,3,3,1,1,2023-02-08,2023-03-01,0,21
94428.0,378019,2,2,1,1,2023-02-08,2023-03-01,0,21
94428.0,501057,75,75,35,35,2023-02-16,2023-03-17,0,29
94428.0,501057,100,100,35,35,2023-02-16,2023-03-09,0,21
94428.0,501065,154,154,46,46,2023-01-24,2023-01-25,0,1
94428.0,501065,79,79,46,46,2023-01-24,2023-03-09,0,44
94428.0,501065,79,79,6,6,2023-02-16,2023-03-09,0,21
94428.0,501065,15,15,6,6,2023-02-16,2023-03-02,0,14
94428.0,501065,79,79,15,15,2023-03-02,2023-03-09,0,7
94428.0,502014,154,154,50,50,2023-01-24,2023-01-25,0,1
94428.0,502014,60,60,50,50,2023-01-24,2023-02-03,0,10
94428.0,502014,100,100,50,50,2023-01-24,2023-03-09,0,44
94428.0,502014,100,100,60,60,2023-02-03,2023-03-09,0,34
94428.0,502014,100,100,20,20,2023-02-07,2023-03-09,0,30
94428.0,502014,30,30,20,20,2023-02-07,2023-03-02,0,23
94428.0,502014,100,100,10,10,2023-02-16,2023-03-09,0,21
94428.0,502014,30,30,10,10,2023-02-16,2023-03-02,0,14
94428.0,502014,100,100,30,30,2023-03-02,2023-03-09,0,7
94428.0,1AA0004,2,2,1,1,2023-02-08,2023-03-01,0,21
99999.0,1628,4,4,1,1,2022-12-20,2022-12-25,0,5
99999.0,1628,2,2,1,1,2022-12-20,2023-01-04,0,15
99999.0,5406,12,12,96,0,2022-09-28,2022-10-11,96,13
99999.0,5406,64,64,2,2,2022-12-29,2023-02-01,0,34
99999.0,5406,64,64,2,2,2022-12-29,2023-02-21,0,54
99999.0,5406,4,4,2,2,2022-12-29,2023-01-04,0,6
99999.0,5406,12,12,2,2,2022-12-29,2023-02-09,0,42
99999.0,5406,12,12,128,0,2022-09-28,2022-10-11,128,13
99999.0,5406,64,64,6,6,2022-12-14,2023-02-01,0,49
99999.0,5406,12,12,6,6,2022-12-14,2023-02-09,0,57
99999.0,5406,96,0,64,64,2022-09-21,2022-09-28,0,7
99999.0,5406,128,0,64,64,2022-09-21,2022-09-28,0,7
99999.0,5406,64,64,64,64,2023-02-01,2023-02-21,0,20
99999.0,5406,64,64,4,4,2023-01-04,2023-02-01,0,28
99999.0,5406,64,64,4,4,2023-01-04,2023-02-21,0,48
99999.0,5406,12,12,4,4,2023-01-04,2023-02-09,0,36
99999.0,5406,4,4,2,2,2023-03-07,2023-03-27,0,20
99999.0,5406,64,64,12,12,2023-02-09,2023-02-21,0,12
99999.0,7402,12,12,1,1,2022-12-20,2022-12-25,0,5
99999.0,7402,3,3,1,1,2022-12-20,2023-01-04,0,15
99999.0,7402,1,1,1,1,2022-12-20,2023-02-17,0,59
99999.0,7402,1,0,1,1,2022-12-20,2023-01-24,0,35
99999.0,7402,1,1,1,1,2023-02-17,2023-03-13,0,24
99999.0,7402,1,1,1,1,2023-02-17,2023-02-21,0,4
99999.0,7402,1,1,1,1,2023-02-17,2023-03-08,0,19
99999.0,7402,1,1,1,1,2023-02-17,2023-03-08,0,19
99999.0,7402,1,1,1,0,2023-01-24,2023-02-17,1,24
99999.0,7402,1,1,1,0,2023-01-24,2023-03-13,1,48
99999.0,7402,1,1,1,0,2023-01-24,2023-02-21,1,28
99999.0,7402,1,1,1,0,2023-01-24,2023-03-08,1,43
99999.0,7402,1,1,1,0,2023-01-24,2023-03-08,1,43
99999.0,7402,1,1,1,1,2023-02-21,2023-03-13,0,20
99999.0,7402,1,1,1,1,2023-02-21,2023-03-08,0,15
99999.0,7402,1,1,1,1,2023-02-21,2023-03-08,0,15
99999.0,7402,1,1,1,1,2023-03-08,2023-03-13,0,5
99999.0,7402,1,1,1,1,2023-03-08,2023-03-13,0,5
99999.0,8400,12,12,24,0,2022-09-28,2022-11-23,24,56
99999.0,8400,24,24,12,12,2022-11-23,2022-11-29,0,6
99999.0,8400,22,22,12,12,2023-02-08,2023-02-21,0,13
99999.0,11403,12,12,5,5,2022-12-14,2023-02-09,0,57
99999.0,12203,1,1,1,1,2023-02-22,2023-03-07,0,13
99999.0,14407,192,192,64,64,2022-09-28,2022-11-23,0,56
99999.0,14407,12,12,160,0,2022-09-28,2022-10-11,160,13
99999.0,14407,192,192,160,0,2022-09-28,2022-11-23,160,56
99999.0,14407,128,128,16,16,2022-12-29,2023-02-01,0,34
99999.0,14407,160,160,16,16,2022-12-29,2023-02-07,0,40
99999.0,14407,160,160,16,16,2022-12-29,2023-02-08,0,41
99999.0,14407,16,16,6,6,2022-12-19,2022-12-29,0,10
99999.0,14407,128,128,6,6,2022-12-19,2023-02-01,0,44
99999.0,14407,160,160,6,6,2022-12-19,2023-02-07,0,50
99999.0,14407,6,6,6,6,2022-12-19,2023-01-09,0,21
99999.0,14407,160,160,6,6,2022-12-19,2023-02-08,0,51
99999.0,14407,192,192,64,64,2022-09-28,2022-11-23,0,56
99999.0,14407,192,192,12,12,2022-10-11,2022-11-23,0,43
99999.0,14407,64,64,160,0,2022-09-21,2022-09-28,160,7
99999.0,14407,160,0,160,0,2022-09-21,2022-09-28,160,7
99999.0,14407,64,64,160,0,2022-09-21,2022-09-28,160,7
99999.0,14407,12,12,160,0,2022-09-21,2022-10-11,160,20
99999.0,14407,160,160,128,128,2023-02-01,2023-02-07,0,6
99999.0,14407,160,160,128,128,2023-02-01,2023-02-08,0,7
99999.0,14407,160,160,160,160,2023-02-07,2023-02-08,0,1
99999.0,14407,128,128,3,3,2023-01-10,2023-02-01,0,22
99999.0,14407,160,160,3,3,2023-01-10,2023-02-07,0,28
99999.0,14407,4,4,3,3,2023-01-10,2023-02-06,0,27
99999.0,14407,3,3,3,3,2023-01-10,2023-02-09,0,30
99999.0,14407,160,160,3,3,2023-01-10,2023-02-08,0,29
99999.0,14407,160,160,4,4,2023-02-06,2023-02-07,0,1
99999.0,14407,160,160,4,4,2023-02-06,2023-02-08,0,2
99999.0,14407,128,128,6,6,2023-01-09,2023-02-01,0,23
99999.0,14407,160,160,6,6,2023-01-09,2023-02-07,0,29
99999.0,14407,160,160,6,6,2023-01-09,2023-02-08,0,30
99999.0,14407,2,2,2,2,2023-02-21,2023-03-10,0,17
99999.0,14407,128,128,1,1,2023-01-11,2023-02-01,0,21
99999.0,14407,160,160,1,1,2023-01-11,2023-02-07,0,27
99999.0,14407,4,4,1,1,2023-01-11,2023-02-06,0,26
99999.0,14407,2,2,1,1,2023-01-11,2023-03-10,0,58
99999.0,14407,2,2,1,1,2023-01-11,2023-02-21,0,41
99999.0,14407,2,2,1,1,2023-01-11,2023-01-19,0,8
99999.0,14407,3,3,1,1,2023-01-11,2023-02-09,0,29
99999.0,14407,160,160,1,1,2023-01-11,2023-02-08,0,28
99999.0,14407,128,128,2,2,2023-01-19,2023-02-01,0,13
99999.0,14407,160,160,2,2,2023-01-19,2023-02-07,0,19
99999.0,14407,4,4,2,2,2023-01-19,2023-02-06,0,18
99999.0,14407,2,2,2,2,2023-01-19,2023-03-10,0,50
99999.0,14407,2,2,2,2,2023-01-19,2023-02-21,0,33
99999.0,14407,3,3,2,2,2023-01-19,2023-02-09,0,21
99999.0,14407,160,160,2,2,2023-01-19,2023-02-08,0,20
99999.0,16403,84,84,2,2,2022-12-25,2023-02-08,0,45
99999.0,24406,7,7,32,0,2022-09-28,2022-10-11,32,13
99999.0,24406,7,7,32,0,2022-09-28,2022-10-11,32,13
99999.0,24406,32,32,1,1,2022-12-30,2023-02-21,0,53
99999.0,24406,4,4,1,1,2022-12-30,2023-01-12,0,13
99999.0,24406,32,32,1,1,2022-12-30,2023-02-07,0,39
99999.0,24406,2,2,1,1,2022-12-30,2023-01-17,0,18
99999.0,24406,1,1,1,1,2022-12-30,2023-02-20,0,52
99999.0,24406,6,6,1,1,2022-12-30,2023-01-11,0,12
99999.0,24406,3,3,1,1,2022-12-30,2023-02-22,0,54
99999.0,24406,49,0,1,1,2022-12-30,2023-01-17,0,18
99999.0,24406,3,3,1,1,2022-12-30,2023-01-26,0,27
99999.0,24406,32,32,2,2,2022-12-30,2023-02-21,0,53
99999.0,24406,4,4,2,2,2022-12-30,2023-01-12,0,13
99999.0,24406,32,32,2,2,2022-12-30,2023-02-07,0,39
99999.0,24406,2,2,2,2,2022-12-30,2023-01-17,0,18
99999.0,24406,6,6,2,2,2022-12-30,2023-01-11,0,12
99999.0,24406,3,3,2,2,2022-12-30,2023-02-22,0,54
99999.0,24406,49,0,2,2,2022-12-30,2023-01-17,0,18
99999.0,24406,3,3,2,2,2022-12-30,2023-01-26,0,27
99999.0,24406,32,32,32,32,2022-12-25,2023-02-21,0,58
99999.0,24406,32,32,32,32,2022-12-25,2023-02-07,0,44
99999.0,24406,49,0,32,32,2022-12-25,2023-01-17,0,23
99999.0,24406,2,2,2,2,2022-12-27,2022-12-30,0,3
99999.0,24406,2,2,2,2,2022-12-27,2022-12-28,0,1
99999.0,24406,32,32,2,2,2022-12-27,2023-02-21,0,56
99999.0,24406,4,4,2,2,2022-12-27,2023-01-12,0,16
99999.0,24406,32,32,2,2,2022-12-27,2023-02-07,0,42
99999.0,24406,2,2,2,2,2022-12-27,2023-01-17,0,21
99999.0,24406,6,6,2,2,2022-12-27,2023-01-11,0,15
99999.0,24406,3,3,2,2,2022-12-27,2023-02-22,0,57
99999.0,24406,49,0,2,2,2022-12-27,2023-01-17,0,21
99999.0,24406,3,3,2,2,2022-12-27,2023-01-26,0,30
99999.0,24406,2,2,2,2,2022-12-28,2022-12-30,0,2
99999.0,24406,32,32,2,2,2022-12-28,2023-02-21,0,55
99999.0,24406,4,4,2,2,2022-12-28,2023-01-12,0,15
99999.0,24406,32,32,2,2,2022-12-28,2023-02-07,0,41
99999.0,24406,2,2,2,2,2022-12-28,2023-01-17,0,20
99999.0,24406,6,6,2,2,2022-12-28,2023-01-11,0,14
99999.0,24406,3,3,2,2,2022-12-28,2023-02-22,0,56
99999.0,24406,49,0,2,2,2022-12-28,2023-01-17,0,20
99999.0,24406,3,3,2,2,2022-12-28,2023-01-26,0,29
99999.0,24406,32,32,4,4,2023-01-12,2023-02-21,0,40
99999.0,24406,32,32,4,4,2023-01-12,2023-02-07,0,26
99999.0,24406,49,0,4,4,2023-01-12,2023-01-17,0,5
99999.0,24406,24,24,4,4,2023-01-12,2023-03-08,0,55
99999.0,24406,6,6,4,4,2023-01-12,2023-03-01,0,48
99999.0,24406,32,32,32,32,2023-02-07,2023-02-21,0,14
99999.0,24406,4,4,2,2,2023-01-17,2023-03-15,0,57
99999.0,24406,32,32,2,2,2023-01-17,2023-02-21,0,35
99999.0,24406,32,32,2,2,2023-01-17,2023-02-07,0,21
99999.0,24406,3,3,2,2,2023-01-17,2023-02-22,0,36
99999.0,24406,24,24,2,2,2023-01-17,2023-03-08,0,50
99999.0,24406,3,3,2,2,2023-01-17,2023-01-26,0,9
99999.0,24406,2,2,2,2,2023-01-17,2023-03-02,0,44
99999.0,24406,6,6,2,2,2023-01-17,2023-03-01,0,43
99999.0,24406,4,4,1,1,2023-02-20,2023-03-15,0,23
99999.0,24406,32,32,1,1,2023-02-20,2023-02-21,0,1
99999.0,24406,3,3,1,1,2023-02-20,2023-02-22,0,2
99999.0,24406,24,24,1,1,2023-02-20,2023-03-08,0,16
99999.0,24406,2,2,1,1,2023-02-20,2023-03-02,0,10
99999.0,24406,1,1,1,1,2023-02-20,2023-03-01,0,9
99999.0,24406,6,6,1,1,2023-02-20,2023-03-01,0,9
99999.0,24406,32,32,6,6,2023-01-11,2023-02-21,0,41
99999.0,24406,32,32,6,6,2023-01-11,2023-02-07,0,27
99999.0,24406,49,0,6,6,2023-01-11,2023-01-17,0,6
99999.0,24406,24,24,6,6,2023-01-11,2023-03-08,0,56
99999.0,24406,6,6,6,6,2023-01-11,2023-03-01,0,49
99999.0,24406,4,4,3,3,2023-02-22,2023-03-15,0,21
99999.0,24406,24,24,3,3,2023-02-22,2023-03-08,0,14
99999.0,24406,6,6,3,3,2023-02-22,2023-03-01,0,7
99999.0,24406,4,4,49,0,2023-01-17,2023-03-15,49,57
99999.0,24406,32,32,49,0,2023-01-17,2023-02-21,49,35
99999.0,24406,32,32,49,0,2023-01-17,2023-02-07,49,21
99999.0,24406,1,1,49,0,2023-01-17,2023-02-20,49,34
99999.0,24406,3,3,49,0,2023-01-17,2023-02-22,49,36
99999.0,24406,24,24,49,0,2023-01-17,2023-03-08,49,50
99999.0,24406,3,3,49,0,2023-01-17,2023-01-26,49,9
99999.0,24406,2,2,49,0,2023-01-17,2023-03-02,49,44
99999.0,24406,1,1,49,0,2023-01-17,2023-03-01,49,43
99999.0,24406,6,6,49,0,2023-01-17,2023-03-01,49,43
99999.0,24406,4,4,3,3,2023-01-26,2023-03-15,0,48
99999.0,24406,32,32,3,3,2023-01-26,2023-02-21,0,26
99999.0,24406,32,32,3,3,2023-01-26,2023-02-07,0,12
99999.0,24406,3,3,3,3,2023-01-26,2023-02-22,0,27
99999.0,24406,24,24,3,3,2023-01-26,2023-03-08,0,41
99999.0,24406,6,6,3,3,2023-01-26,2023-03-01,0,34
99999.0,24406,4,4,2,2,2023-03-02,2023-03-15,0,13
99999.0,24406,24,24,2,2,2023-03-02,2023-03-08,0,6
99999.0,24406,4,4,1,1,2023-03-01,2023-03-15,0,14
99999.0,24406,24,24,1,1,2023-03-01,2023-03-08,0,7
99999.0,24406,2,2,1,1,2023-03-01,2023-03-02,0,1
99999.0,24406,24,24,6,6,2023-03-01,2023-03-08,0,7
99999.0,26402,25,25,25,25,2023-01-17,2023-02-06,0,20
99999.0,34405,4,4,2,2,2022-12-01,2022-12-30,0,29
99999.0,34405,32,32,2,2,2022-12-01,2022-12-25,0,24
99999.0,34405,4,4,2,2,2022-12-01,2022-12-20,0,19
99999.0,34405,2,2,2,2,2022-12-01,2023-01-24,0,54
99999.0,34405,10,10,2,2,2022-12-01,2023-01-06,0,36
99999.0,34405,4,4,2,2,2022-12-01,2023-01-03,0,33
99999.0,34405,20,20,2,2,2022-12-01,2023-01-27,0,57
99999.0,34405,4,4,2,2,2022-12-01,2023-01-09,0,39
99999.0,34405,3,3,2,2,2022-12-01,2023-01-30,0,60
99999.0,34405,2,2,2,2,2022-12-01,2023-01-27,0,57
99999.0,34405,8,8,2,2,2022-12-01,2023-01-03,0,33
99999.0,34405,5,0,2,2,2022-12-01,2023-01-20,0,50
99999.0,34405,23,23,16,16,2022-09-28,2022-10-14,0,16
99999.0,34405,64,64,16,16,2022-09-28,2022-11-23,0,56
99999.0,34405,23,23,32,0,2022-09-28,2022-10-14,32,16
99999.0,34405,64,64,32,0,2022-09-28,2022-11-23,32,56
99999.0,34405,5,5,4,4,2022-12-30,2023-02-20,0,52
99999.0,34405,64,64,4,4,2022-12-30,2023-02-01,0,33
99999.0,34405,96,96,4,4,2022-12-30,2023-02-07,0,39
99999.0,34405,10,10,4,4,2022-12-30,2023-01-06,0,7
99999.0,34405,4,4,4,4,2022-12-30,2023-01-03,0,4
99999.0,34405,20,20,4,4,2022-12-30,2023-01-27,0,28
99999.0,34405,4,4,4,4,2022-12-30,2023-01-09,0,10
99999.0,34405,16,16,4,4,2022-12-30,2023-02-08,0,40
99999.0,34405,10,10,4,4,2022-12-30,2023-02-13,0,45
99999.0,34405,6,6,4,4,2022-12-30,2023-02-08,0,40
99999.0,34405,5,5,4,4,2022-12-30,2023-02-23,0,55
99999.0,34405,5,5,4,4,2022-12-30,2023-02-14,0,46
99999.0,34405,7,7,4,4,2022-12-30,2023-02-13,0,45
99999.0,34405,4,4,4,4,2022-12-30,2023-02-10,0,42
99999.0,34405,8,8,4,4,2022-12-30,2023-01-03,0,4
99999.0,34405,5,0,4,4,2022-12-30,2023-01-20,0,21
99999.0,34405,35,35,4,4,2022-12-30,2023-02-17,0,49
99999.0,34405,7,7,4,4,2022-12-30,2023-02-21,0,53
99999.0,34405,4,4,4,4,2022-12-30,2023-02-23,0,55
99999.0,34405,300,300,4,4,2022-12-30,2023-02-15,0,47
99999.0,34405,64,64,23,23,2022-10-14,2022-11-23,0,40
99999.0,34405,64,64,32,32,2022-12-25,2023-02-01,0,38
99999.0,34405,96,96,32,32,2022-12-25,2023-02-07,0,44
99999.0,34405,35,35,32,32,2022-12-25,2023-02-17,0,54
99999.0,34405,300,300,32,32,2022-12-25,2023-02-15,0,52
99999.0,34405,4,4,4,4,2022-12-20,2022-12-30,0,10
99999.0,34405,32,32,4,4,2022-12-20,2022-12-25,0,5
99999.0,34405,64,64,4,4,2022-12-20,2023-02-01,0,43
99999.0,34405,96,96,4,4,2022-12-20,2023-02-07,0,49
99999.0,34405,10,10,4,4,2022-12-20,2023-01-06,0,17
99999.0,34405,4,4,4,4,2022-12-20,2023-01-03,0,14
99999.0,34405,20,20,4,4,2022-12-20,2023-01-27,0,38
99999.0,34405,4,4,4,4,2022-12-20,2023-01-09,0,20
99999.0,34405,16,16,4,4,2022-12-20,2023-02-08,0,50
99999.0,34405,10,10,4,4,2022-12-20,2023-02-13,0,55
99999.0,34405,6,6,4,4,2022-12-20,2023-02-08,0,50
99999.0,34405,5,5,4,4,2022-12-20,2023-02-14,0,56
99999.0,34405,7,7,4,4,2022-12-20,2023-02-13,0,55
99999.0,34405,4,4,4,4,2022-12-20,2023-02-10,0,52
99999.0,34405,8,8,4,4,2022-12-20,2023-01-03,0,14
99999.0,34405,5,0,4,4,2022-12-20,2023-01-20,0,31
99999.0,34405,35,35,4,4,2022-12-20,2023-02-17,0,59
99999.0,34405,300,300,4,4,2022-12-20,2023-02-15,0,57
99999.0,34405,5,5,5,5,2023-02-20,2023-02-23,0,3
99999.0,34405,16,16,5,5,2023-02-20,2023-03-02,0,10
99999.0,34405,6,6,5,5,2023-02-20,2023-03-09,0,17
99999.0,34405,7,7,5,5,2023-02-20,2023-02-21,0,1
99999.0,34405,13,13,5,5,2023-02-20,2023-03-16,0,24
99999.0,34405,96,96,64,64,2023-02-01,2023-02-07,0,6
99999.0,34405,300,300,64,64,2023-02-01,2023-02-15,0,14
99999.0,34405,300,300,96,96,2023-02-07,2023-02-15,0,8
99999.0,34405,5,5,1,1,2023-01-31,2023-02-20,0,20
99999.0,34405,64,64,1,1,2023-01-31,2023-02-01,0,1
99999.0,34405,2,2,1,1,2023-01-31,2023-03-23,0,51
99999.0,34405,96,96,1,1,2023-01-31,2023-02-07,0,7
99999.0,34405,3,3,1,1,2023-01-31,2023-02-06,0,6
99999.0,34405,2,2,1,1,2023-01-31,2023-03-20,0,48
99999.0,34405,1,1,1,1,2023-01-31,2023-02-10,0,10
99999.0,34405,4,4,1,1,2023-01-31,2023-03-06,0,34
99999.0,34405,3,3,1,1,2023-01-31,2023-03-03,0,31
99999.0,34405,16,16,1,1,2023-01-31,2023-02-08,0,8
99999.0,34405,10,10,1,1,2023-01-31,2023-02-13,0,13
99999.0,34405,6,6,1,1,2023-01-31,2023-02-08,0,8
99999.0,34405,5,5,1,1,2023-01-31,2023-02-23,0,23
99999.0,34405,4,4,1,1,2023-01-31,2023-03-13,0,41
99999.0,34405,5,5,1,1,2023-01-31,2023-02-14,0,14
99999.0,34405,7,7,1,1,2023-01-31,2023-02-13,0,13
99999.0,34405,4,4,1,1,2023-01-31,2023-02-10,0,10
99999.0,34405,3,3,1,1,2023-01-31,2023-02-27,0,27
99999.0,34405,16,16,1,1,2023-01-31,2023-03-02,0,30
99999.0,34405,6,6,1,1,2023-01-31,2023-03-09,0,37
99999.0,34405,35,35,1,1,2023-01-31,2023-02-17,0,17
99999.0,34405,7,7,1,1,2023-01-31,2023-02-21,0,21
99999.0,34405,1,1,1,1,2023-01-31,2023-03-10,0,38
99999.0,34405,4,4,1,1,2023-01-31,2023-02-23,0,23
99999.0,34405,300,300,1,1,2023-01-31,2023-02-15,0,15
99999.0,34405,13,13,1,1,2023-01-31,2023-03-16,0,44
99999.0,34405,2,2,1,1,2023-01-31,2023-03-06,0,34
99999.0,34405,5,5,2,2,2023-01-24,2023-02-20,0,27
99999.0,34405,64,64,2,2,2023-01-24,2023-02-01,0,8
99999.0,34405,2,2,2,2,2023-01-24,2023-03-23,0,58
99999.0,34405,96,96,2,2,2023-01-24,2023-02-07,0,14
99999.0,34405,3,3,2,2,2023-01-24,2023-02-06,0,13
99999.0,34405,2,2,2,2,2023-01-24,2023-03-20,0,55
99999.0,34405,20,20,2,2,2023-01-24,2023-01-27,0,3
99999.0,34405,4,4,2,2,2023-01-24,2023-03-06,0,41
99999.0,34405,3,3,2,2,2023-01-24,2023-03-03,0,38
99999.0,34405,16,16,2,2,2023-01-24,2023-02-08,0,15
99999.0,34405,10,10,2,2,2023-01-24,2023-02-13,0,20
99999.0,34405,3,3,2,2,2023-01-24,2023-01-30,0,6
99999.0,34405,2,2,2,2,2023-01-24,2023-01-27,0,3
99999.0,34405,6,6,2,2,2023-01-24,2023-02-08,0,15
99999.0,34405,5,5,2,2,2023-01-24,2023-02-23,0,30
99999.0,34405,4,4,2,2,2023-01-24,2023-03-13,0,48
99999.0,34405,5,5,2,2,2023-01-24,2023-02-14,0,21
99999.0,34405,7,7,2,2,2023-01-24,2023-02-13,0,20
99999.0,34405,4,4,2,2,2023-01-24,2023-02-10,0,17
99999.0,34405,3,3,2,2,2023-01-24,2023-02-27,0,34
99999.0,34405,16,16,2,2,2023-01-24,2023-03-02,0,37
99999.0,34405,6,6,2,2,2023-01-24,2023-03-09,0,44
99999.0,34405,35,35,2,2,2023-01-24,2023-02-17,0,24
99999.0,34405,7,7,2,2,2023-01-24,2023-02-21,0,28
99999.0,34405,4,4,2,2,2023-01-24,2023-02-23,0,30
99999.0,34405,300,300,2,2,2023-01-24,2023-02-15,0,22
99999.0,34405,13,13,2,2,2023-01-24,2023-03-16,0,51
99999.0,34405,2,2,2,2,2023-01-24,2023-03-06,0,41
99999.0,34405,5,5,1,1,2023-01-30,2023-02-20,0,21
99999.0,34405,64,64,1,1,2023-01-30,2023-02-01,0,2
99999.0,34405,2,2,1,1,2023-01-30,2023-03-23,0,52
99999.0,34405,96,96,1,1,2023-01-30,2023-02-07,0,8
99999.0,34405,1,1,1,1,2023-01-30,2023-01-31,0,1
99999.0,34405,3,3,1,1,2023-01-30,2023-02-06,0,7
99999.0,34405,2,2,1,1,2023-01-30,2023-03-20,0,49
99999.0,34405,1,1,1,1,2023-01-30,2023-02-10,0,11
99999.0,34405,4,4,1,1,2023-01-30,2023-03-06,0,35
99999.0,34405,3,3,1,1,2023-01-30,2023-03-03,0,32
99999.0,34405,16,16,1,1,2023-01-30,2023-02-08,0,9
99999.0,34405,10,10,1,1,2023-01-30,2023-02-13,0,14
99999.0,34405,6,6,1,1,2023-01-30,2023-02-08,0,9
99999.0,34405,5,5,1,1,2023-01-30,2023-02-23,0,24
99999.0,34405,4,4,1,1,2023-01-30,2023-03-13,0,42
99999.0,34405,5,5,1,1,2023-01-30,2023-02-14,0,15
99999.0,34405,7,7,1,1,2023-01-30,2023-02-13,0,14
99999.0,34405,4,4,1,1,2023-01-30,2023-02-10,0,11
99999.0,34405,3,3,1,1,2023-01-30,2023-02-27,0,28
99999.0,34405,16,16,1,1,2023-01-30,2023-03-02,0,31
99999.0,34405,6,6,1,1,2023-01-30,2023-03-09,0,38
99999.0,34405,35,35,1,1,2023-01-30,2023-02-17,0,18
99999.0,34405,7,7,1,1,2023-01-30,2023-02-21,0,22
99999.0,34405,1,1,1,1,2023-01-30,2023-03-10,0,39
99999.0,34405,4,4,1,1,2023-01-30,2023-02-23,0,24
99999.0,34405,300,300,1,1,2023-01-30,2023-02-15,0,16
99999.0,34405,13,13,1,1,2023-01-30,2023-03-16,0,45
99999.0,34405,2,2,1,1,2023-01-30,2023-03-06,0,35
99999.0,34405,5,5,3,3,2023-02-06,2023-02-20,0,14
99999.0,34405,96,96,3,3,2023-02-06,2023-02-07,0,1
99999.0,34405,4,4,3,3,2023-02-06,2023-03-06,0,28
99999.0,34405,3,3,3,3,2023-02-06,2023-03-03,0,25
99999.0,34405,16,16,3,3,2023-02-06,2023-02-08,0,2
99999.0,34405,10,10,3,3,2023-02-06,2023-02-13,0,7
99999.0,34405,6,6,3,3,2023-02-06,2023-02-08,0,2
99999.0,34405,5,5,3,3,2023-02-06,2023-02-23,0,17
99999.0,34405,4,4,3,3,2023-02-06,2023-03-13,0,35
99999.0,34405,5,5,3,3,2023-02-06,2023-02-14,0,8
99999.0,34405,7,7,3,3,2023-02-06,2023-02-13,0,7
99999.0,34405,4,4,3,3,2023-02-06,2023-02-10,0,4
99999.0,34405,3,3,3,3,2023-02-06,2023-02-27,0,21
99999.0,34405,16,16,3,3,2023-02-06,2023-03-02,0,24
99999.0,34405,6,6,3,3,2023-02-06,2023-03-09,0,31
99999.0,34405,35,35,3,3,2023-02-06,2023-02-17,0,11
99999.0,34405,7,7,3,3,2023-02-06,2023-02-21,0,15
99999.0,34405,4,4,3,3,2023-02-06,2023-02-23,0,17
99999.0,34405,300,300,3,3,2023-02-06,2023-02-15,0,9
99999.0,34405,13,13,3,3,2023-02-06,2023-03-16,0,38
99999.0,34405,64,64,10,10,2023-01-06,2023-02-01,0,26
99999.0,34405,96,96,10,10,2023-01-06,2023-02-07,0,32
99999.0,34405,20,20,10,10,2023-01-06,2023-01-27,0,21
99999.0,34405,16,16,10,10,2023-01-06,2023-02-08,0,33
99999.0,34405,10,10,10,10,2023-01-06,2023-02-13,0,38
99999.0,34405,16,16,10,10,2023-01-06,2023-03-02,0,55
99999.0,34405,35,35,10,10,2023-01-06,2023-02-17,0,42
99999.0,34405,300,300,10,10,2023-01-06,2023-02-15,0,40
99999.0,34405,5,5,4,4,2023-01-03,2023-02-20,0,48
99999.0,34405,64,64,4,4,2023-01-03,2023-02-01,0,29
99999.0,34405,96,96,4,4,2023-01-03,2023-02-07,0,35
99999.0,34405,10,10,4,4,2023-01-03,2023-01-06,0,3
99999.0,34405,20,20,4,4,2023-01-03,2023-01-27,0,24
99999.0,34405,4,4,4,4,2023-01-03,2023-01-09,0,6
99999.0,34405,16,16,4,4,2023-01-03,2023-02-08,0,36
99999.0,34405,10,10,4,4,2023-01-03,2023-02-13,0,41
99999.0,34405,6,6,4,4,2023-01-03,2023-02-08,0,36
99999.0,34405,5,5,4,4,2023-01-03,2023-02-23,0,51
99999.0,34405,5,5,4,4,2023-01-03,2023-02-14,0,42
99999.0,34405,7,7,4,4,2023-01-03,2023-02-13,0,41
99999.0,34405,4,4,4,4,2023-01-03,2023-02-10,0,38
99999.0,34405,16,16,4,4,2023-01-03,2023-03-02,0,58
99999.0,34405,5,0,4,4,2023-01-03,2023-01-20,0,17
99999.0,34405,35,35,4,4,2023-01-03,2023-02-17,0,45
99999.0,34405,7,7,4,4,2023-01-03,2023-02-21,0,49
99999.0,34405,4,4,4,4,2023-01-03,2023-02-23,0,51
99999.0,34405,300,300,4,4,2023-01-03,2023-02-15,0,43
99999.0,34405,2,2,2,2,2023-03-20,2023-03-23,0,3
99999.0,34405,5,5,1,1,2023-02-10,2023-02-20,0,10
99999.0,34405,2,2,1,1,2023-02-10,2023-03-23,0,41
99999.0,34405,2,2,1,1,2023-02-10,2023-03-20,0,38
99999.0,34405,4,4,1,1,2023-02-10,2023-03-06,0,24
99999.0,34405,3,3,1,1,2023-02-10,2023-03-03,0,21
99999.0,34405,10,10,1,1,2023-02-10,2023-02-13,0,3
99999.0,34405,5,5,1,1,2023-02-10,2023-02-23,0,13
99999.0,34405,4,4,1,1,2023-02-10,2023-03-13,0,31
99999.0,34405,5,5,1,1,2023-02-10,2023-02-14,0,4
99999.0,34405,7,7,1,1,2023-02-10,2023-02-13,0,3
99999.0,34405,3,3,1,1,2023-02-10,2023-02-27,0,17
99999.0,34405,16,16,1,1,2023-02-10,2023-03-02,0,20
99999.0,34405,6,6,1,1,2023-02-10,2023-03-09,0,27
99999.0,34405,35,35,1,1,2023-02-10,2023-02-17,0,7
99999.0,34405,7,7,1,1,2023-02-10,2023-02-21,0,11
99999.0,34405,1,1,1,1,2023-02-10,2023-03-10,0,28
99999.0,34405,4,4,1,1,2023-02-10,2023-02-23,0,13
99999.0,34405,300,300,1,1,2023-02-10,2023-02-15,0,5
99999.0,34405,13,13,1,1,2023-02-10,2023-03-16,0,34
99999.0,34405,2,2,1,1,2023-02-10,2023-03-06,0,24
99999.0,34405,64,64,20,20,2023-01-27,2023-02-01,0,5
99999.0,34405,96,96,20,20,2023-01-27,2023-02-07,0,11
99999.0,34405,35,35,20,20,2023-01-27,2023-02-17,0,21
99999.0,34405,300,300,20,20,2023-01-27,2023-02-15,0,19
99999.0,34405,5,5,4,4,2023-01-09,2023-02-20,0,42
99999.0,34405,64,64,4,4,2023-01-09,2023-02-01,0,23
99999.0,34405,96,96,4,4,2023-01-09,2023-02-07,0,29
99999.0,34405,20,20,4,4,2023-01-09,2023-01-27,0,18
99999.0,34405,4,4,4,4,2023-01-09,2023-03-06,0,56
99999.0,34405,16,16,4,4,2023-01-09,2023-02-08,0,30
99999.0,34405,10,10,4,4,2023-01-09,2023-02-13,0,35
99999.0,34405,6,6,4,4,2023-01-09,2023-02-08,0,30
99999.0,34405,5,5,4,4,2023-01-09,2023-02-23,0,45
99999.0,34405,5,5,4,4,2023-01-09,2023-02-14,0,36
99999.0,34405,7,7,4,4,2023-01-09,2023-02-13,0,35
99999.0,34405,4,4,4,4,2023-01-09,2023-02-10,0,32
99999.0,34405,16,16,4,4,2023-01-09,2023-03-02,0,52
99999.0,34405,5,0,4,4,2023-01-09,2023-01-20,0,11
99999.0,34405,6,6,4,4,2023-01-09,2023-03-09,0,59
99999.0,34405,35,35,4,4,2023-01-09,2023-02-17,0,39
99999.0,34405,7,7,4,4,2023-01-09,2023-02-21,0,43
99999.0,34405,4,4,4,4,2023-01-09,2023-02-23,0,45
99999.0,34405,300,300,4,4,2023-01-09,2023-02-15,0,37
99999.0,34405,4,4,4,4,2023-03-06,2023-03-13,0,7
99999.0,34405,6,6,4,4,2023-03-06,2023-03-09,0,3
99999.0,34405,13,13,4,4,2023-03-06,2023-03-16,0,10
99999.0,34405,4,4,3,3,2023-03-03,2023-03-06,0,3
99999.0,34405,4,4,3,3,2023-03-03,2023-03-13,0,10
99999.0,34405,6,6,3,3,2023-03-03,2023-03-09,0,6
99999.0,34405,13,13,3,3,2023-03-03,2023-03-16,0,13
99999.0,34405,16,16,16,16,2023-02-08,2023-03-02,0,22
99999.0,34405,35,35,16,16,2023-02-08,2023-02-17,0,9
99999.0,34405,300,300,16,16,2023-02-08,2023-02-15,0,7
99999.0,34405,16,16,10,10,2023-02-13,2023-03-02,0,17
99999.0,34405,35,35,10,10,2023-02-13,2023-02-17,0,4
99999.0,34405,300,300,10,10,2023-02-13,2023-02-15,0,2
99999.0,34405,13,13,10,10,2023-02-13,2023-03-16,0,31
99999.0,34405,5,5,3,3,2023-01-30,2023-02-20,0,21
99999.0,34405,64,64,3,3,2023-01-30,2023-02-01,0,2
99999.0,34405,96,96,3,3,2023-01-30,2023-02-07,0,8
99999.0,34405,3,3,3,3,2023-01-30,2023-02-06,0,7
99999.0,34405,4,4,3,3,2023-01-30,2023-03-06,0,35
99999.0,34405,3,3,3,3,2023-01-30,2023-03-03,0,32
99999.0,34405,16,16,3,3,2023-01-30,2023-02-08,0,9
99999.0,34405,10,10,3,3,2023-01-30,2023-02-13,0,14
99999.0,34405,6,6,3,3,2023-01-30,2023-02-08,0,9
99999.0,34405,5,5,3,3,2023-01-30,2023-02-23,0,24
99999.0,34405,4,4,3,3,2023-01-30,2023-03-13,0,42
99999.0,34405,5,5,3,3,2023-01-30,2023-02-14,0,15
99999.0,34405,7,7,3,3,2023-01-30,2023-02-13,0,14
99999.0,34405,4,4,3,3,2023-01-30,2023-02-10,0,11
99999.0,34405,3,3,3,3,2023-01-30,2023-02-27,0,28
99999.0,34405,16,16,3,3,2023-01-30,2023-03-02,0,31
99999.0,34405,6,6,3,3,2023-01-30,2023-03-09,0,38
99999.0,34405,35,35,3,3,2023-01-30,2023-02-17,0,18
99999.0,34405,7,7,3,3,2023-01-30,2023-02-21,0,22
99999.0,34405,4,4,3,3,2023-01-30,2023-02-23,0,24
99999.0,34405,300,300,3,3,2023-01-30,2023-02-15,0,16
99999.0,34405,13,13,3,3,2023-01-30,2023-03-16,0,45
99999.0,34405,5,5,2,2,2023-01-27,2023-02-20,0,24
99999.0,34405,64,64,2,2,2023-01-27,2023-02-01,0,5
99999.0,34405,2,2,2,2,2023-01-27,2023-03-23,0,55
99999.0,34405,96,96,2,2,2023-01-27,2023-02-07,0,11
99999.0,34405,3,3,2,2,2023-01-27,2023-02-06,0,10
99999.0,34405,2,2,2,2,2023-01-27,2023-03-20,0,52
99999.0,34405,4,4,2,2,2023-01-27,2023-03-06,0,38
99999.0,34405,3,3,2,2,2023-01-27,2023-03-03,0,35
99999.0,34405,16,16,2,2,2023-01-27,2023-02-08,0,12
99999.0,34405,10,10,2,2,2023-01-27,2023-02-13,0,17
99999.0,34405,3,3,2,2,2023-01-27,2023-01-30,0,3
99999.0,34405,6,6,2,2,2023-01-27,2023-02-08,0,12
99999.0,34405,5,5,2,2,2023-01-27,2023-02-23,0,27
99999.0,34405,4,4,2,2,2023-01-27,2023-03-13,0,45
99999.0,34405,5,5,2,2,2023-01-27,2023-02-14,0,18
99999.0,34405,7,7,2,2,2023-01-27,2023-02-13,0,17
99999.0,34405,4,4,2,2,2023-01-27,2023-02-10,0,14
99999.0,34405,3,3,2,2,2023-01-27,2023-02-27,0,31
99999.0,34405,16,16,2,2,2023-01-27,2023-03-02,0,34
99999.0,34405,6,6,2,2,2023-01-27,2023-03-09,0,41
99999.0,34405,35,35,2,2,2023-01-27,2023-02-17,0,21
99999.0,34405,7,7,2,2,2023-01-27,2023-02-21,0,25
99999.0,34405,4,4,2,2,2023-01-27,2023-02-23,0,27
99999.0,34405,300,300,2,2,2023-01-27,2023-02-15,0,19
99999.0,34405,13,13,2,2,2023-01-27,2023-03-16,0,48
99999.0,34405,2,2,2,2,2023-01-27,2023-03-06,0,38
99999.0,34405,10,10,6,6,2023-02-08,2023-02-13,0,5
99999.0,34405,7,7,6,6,2023-02-08,2023-02-13,0,5
99999.0,34405,16,16,6,6,2023-02-08,2023-03-02,0,22
99999.0,34405,6,6,6,6,2023-02-08,2023-03-09,0,29
99999.0,34405,35,35,6,6,2023-02-08,2023-02-17,0,9
99999.0,34405,7,7,6,6,2023-02-08,2023-02-21,0,13
99999.0,34405,300,300,6,6,2023-02-08,2023-02-15,0,7
99999.0,34405,13,13,6,6,2023-02-08,2023-03-16,0,36
99999.0,34405,16,16,5,5,2023-02-23,2023-03-02,0,7
99999.0,34405,6,6,5,5,2023-02-23,2023-03-09,0,14
99999.0,34405,13,13,5,5,2023-02-23,2023-03-16,0,21
99999.0,34405,13,13,4,4,2023-03-13,2023-03-16,0,3
99999.0,34405,5,5,5,5,2023-02-14,2023-02-20,0,6
99999.0,34405,5,5,5,5,2023-02-14,2023-02-23,0,9
99999.0,34405,16,16,5,5,2023-02-14,2023-03-02,0,16
99999.0,34405,6,6,5,5,2023-02-14,2023-03-09,0,23
99999.0,34405,35,35,5,5,2023-02-14,2023-02-17,0,3
99999.0,34405,7,7,5,5,2023-02-14,2023-02-21,0,7
99999.0,34405,300,300,5,5,2023-02-14,2023-02-15,0,1
99999.0,34405,13,13,5,5,2023-02-14,2023-03-16,0,30
99999.0,34405,16,16,7,7,2023-02-13,2023-03-02,0,17
99999.0,34405,35,35,7,7,2023-02-13,2023-02-17,0,4
99999.0,34405,7,7,7,7,2023-02-13,2023-02-21,0,8
99999.0,34405,300,300,7,7,2023-02-13,2023-02-15,0,2
99999.0,34405,13,13,7,7,2023-02-13,2023-03-16,0,31
99999.0,34405,5,5,4,4,2023-02-10,2023-02-20,0,10
99999.0,34405,4,4,4,4,2023-02-10,2023-03-06,0,24
99999.0,34405,10,10,4,4,2023-02-10,2023-02-13,0,3
99999.0,34405,5,5,4,4,2023-02-10,2023-02-23,0,13
99999.0,34405,4,4,4,4,2023-02-10,2023-03-13,0,31
99999.0,34405,5,5,4,4,2023-02-10,2023-02-14,0,4
99999.0,34405,7,7,4,4,2023-02-10,2023-02-13,0,3
99999.0,34405,16,16,4,4,2023-02-10,2023-03-02,0,20
99999.0,34405,6,6,4,4,2023-02-10,2023-03-09,0,27
99999.0,34405,35,35,4,4,2023-02-10,2023-02-17,0,7
99999.0,34405,7,7,4,4,2023-02-10,2023-02-21,0,11
99999.0,34405,4,4,4,4,2023-02-10,2023-02-23,0,13
99999.0,34405,300,300,4,4,2023-02-10,2023-02-15,0,5
99999.0,34405,13,13,4,4,2023-02-10,2023-03-16,0,34
99999.0,34405,4,4,3,3,2023-02-27,2023-03-06,0,7
99999.0,34405,3,3,3,3,2023-02-27,2023-03-03,0,4
99999.0,34405,4,4,3,3,2023-02-27,2023-03-13,0,14
99999.0,34405,16,16,3,3,2023-02-27,2023-03-02,0,3
99999.0,34405,6,6,3,3,2023-02-27,2023-03-09,0,10
99999.0,34405,13,13,3,3,2023-02-27,2023-03-16,0,17
99999.0,34405,64,64,8,8,2023-01-03,2023-02-01,0,29
99999.0,34405,96,96,8,8,2023-01-03,2023-02-07,0,35
99999.0,34405,10,10,8,8,2023-01-03,2023-01-06,0,3
99999.0,34405,20,20,8,8,2023-01-03,2023-01-27,0,24
99999.0,34405,16,16,8,8,2023-01-03,2023-02-08,0,36
99999.0,34405,10,10,8,8,2023-01-03,2023-02-13,0,41
99999.0,34405,16,16,8,8,2023-01-03,2023-03-02,0,58
99999.0,34405,35,35,8,8,2023-01-03,2023-02-17,0,45
99999.0,34405,300,300,8,8,2023-01-03,2023-02-15,0,43
99999.0,34405,5,5,5,0,2023-01-20,2023-02-20,5,31
99999.0,34405,64,64,5,0,2023-01-20,2023-02-01,5,12
99999.0,34405,96,96,5,0,2023-01-20,2023-02-07,5,18
99999.0,34405,1,1,5,0,2023-01-20,2023-01-31,5,11
99999.0,34405,2,2,5,0,2023-01-20,2023-01-24,5,4
99999.0,34405,1,1,5,0,2023-01-20,2023-01-30,5,10
99999.0,34405,3,3,5,0,2023-01-20,2023-02-06,5,17
99999.0,34405,2,2,5,0,2023-01-20,2023-03-20,5,59
99999.0,34405,1,1,5,0,2023-01-20,2023-02-10,5,21
99999.0,34405,20,20,5,0,2023-01-20,2023-01-27,5,7
99999.0,34405,4,4,5,0,2023-01-20,2023-03-06,5,45
99999.0,34405,3,3,5,0,2023-01-20,2023-03-03,5,42
99999.0,34405,16,16,5,0,2023-01-20,2023-02-08,5,19
99999.0,34405,10,10,5,0,2023-01-20,2023-02-13,5,24
99999.0,34405,3,3,5,0,2023-01-20,2023-01-30,5,10
99999.0,34405,2,2,5,0,2023-01-20,2023-01-27,5,7
99999.0,34405,6,6,5,0,2023-01-20,2023-02-08,5,19
99999.0,34405,5,5,5,0,2023-01-20,2023-02-23,5,34
99999.0,34405,4,4,5,0,2023-01-20,2023-03-13,5,52
99999.0,34405,5,5,5,0,2023-01-20,2023-02-14,5,25
99999.0,34405,7,7,5,0,2023-01-20,2023-02-13,5,24
99999.0,34405,4,4,5,0,2023-01-20,2023-02-10,5,21
99999.0,34405,3,3,5,0,2023-01-20,2023-02-27,5,38
99999.0,34405,16,16,5,0,2023-01-20,2023-03-02,5,41
99999.0,34405,6,6,5,0,2023-01-20,2023-03-09,5,48
99999.0,34405,35,35,5,0,2023-01-20,2023-02-17,5,28
99999.0,34405,7,7,5,0,2023-01-20,2023-02-21,5,32
99999.0,34405,1,1,5,0,2023-01-20,2023-03-10,5,49
99999.0,34405,4,4,5,0,2023-01-20,2023-02-23,5,34
99999.0,34405,300,300,5,0,2023-01-20,2023-02-15,5,26
99999.0,34405,13,13,5,0,2023-01-20,2023-03-16,5,55
99999.0,34405,2,2,5,0,2023-01-20,2023-03-06,5,45
99999.0,34405,13,13,6,6,2023-03-09,2023-03-16,0,7
99999.0,34405,16,16,7,7,2023-02-21,2023-03-02,0,9
99999.0,34405,13,13,7,7,2023-02-21,2023-03-16,0,23
99999.0,34405,2,2,1,1,2023-03-10,2023-03-23,0,13
99999.0,34405,2,2,1,1,2023-03-10,2023-03-20,0,10
99999.0,34405,4,4,1,1,2023-03-10,2023-03-13,0,3
99999.0,34405,13,13,1,1,2023-03-10,2023-03-16,0,6
99999.0,34405,4,4,4,4,2023-02-23,2023-03-06,0,11
99999.0,34405,4,4,4,4,2023-02-23,2023-03-13,0,18
99999.0,34405,16,16,4,4,2023-02-23,2023-03-02,0,7
99999.0,34405,6,6,4,4,2023-02-23,2023-03-09,0,14
99999.0,34405,13,13,4,4,2023-02-23,2023-03-16,0,21
99999.0,34405,2,2,2,2,2023-03-06,2023-03-23,0,17
99999.0,34405,2,2,2,2,2023-03-06,2023-03-20,0,14
99999.0,34405,4,4,2,2,2023-03-06,2023-03-13,0,7
99999.0,34405,6,6,2,2,2023-03-06,2023-03-09,0,3
99999.0,34405,13,13,2,2,2023-03-06,2023-03-16,0,10
99999.0,45626,22,22,1,1,2023-01-10,2023-01-26,0,16
99999.0,48406,20,20,96,0,2022-09-28,2022-10-11,96,13
99999.0,48406,20,0,96,0,2022-09-28,2022-10-11,96,13
99999.0,48406,96,96,20,20,2022-10-11,2022-11-29,0,49
99999.0,48406,96,96,20,0,2022-10-11,2022-11-29,20,49
99999.0,56409,84,84,2,2,2023-01-26,2023-02-08,0,13
99999.0,57407,64,64,64,0,2022-09-28,2022-11-23,64,56
99999.0,57407,64,64,64,64,2022-09-28,2022-11-23,0,56
99999.0,57407,64,0,64,64,2022-09-21,2022-09-28,0,7
99999.0,57407,64,64,64,64,2022-09-21,2022-09-28,0,7
99999.0,58405,36,36,6,6,2022-12-25,2023-02-08,0,45
99999.0,62349,21,21,64,0,2022-09-28,2022-10-14,64,16
99999.0,62349,5,0,4,4,2022-12-28,2023-02-20,0,54
99999.0,62349,4,4,4,4,2022-12-28,2023-01-31,0,34
99999.0,62349,8,8,4,4,2022-12-28,2023-01-26,0,29
99999.0,62349,6,6,4,4,2022-12-28,2023-01-09,0,12
99999.0,62349,4,4,4,4,2022-12-28,2023-01-20,0,23
99999.0,62349,5,5,4,4,2022-12-28,2023-02-14,0,48
99999.0,62349,48,48,21,21,2022-10-14,2022-11-29,0,46
99999.0,62349,64,0,64,64,2022-09-15,2022-09-28,0,13
99999.0,62349,3,0,1,1,2023-03-17,2023-03-24,0,7
99999.0,62349,3,3,1,1,2023-03-17,2023-03-24,0,7
99999.0,62349,3,0,5,0,2023-02-20,2023-03-24,5,32
99999.0,62349,3,3,5,0,2023-02-20,2023-03-24,5,32
99999.0,62349,1,1,5,0,2023-02-20,2023-03-17,5,25
99999.0,62349,5,0,3,3,2023-01-19,2023-02-20,0,32
99999.0,62349,4,4,3,3,2023-01-19,2023-01-31,0,12
99999.0,62349,8,8,3,3,2023-01-19,2023-01-26,0,7
99999.0,62349,4,4,3,3,2023-01-19,2023-01-20,0,1
99999.0,62349,5,5,3,3,2023-01-19,2023-02-14,0,26
99999.0,62349,5,0,4,4,2023-01-31,2023-02-20,0,20
99999.0,62349,5,5,4,4,2023-01-31,2023-02-14,0,14
99999.0,62349,3,0,1,1,2023-02-14,2023-03-24,0,38
99999.0,62349,3,3,1,1,2023-02-14,2023-03-24,0,38
99999.0,62349,1,1,1,1,2023-02-14,2023-03-17,0,31
99999.0,62349,5,0,1,1,2023-02-14,2023-02-20,0,6
99999.0,62349,1,1,1,1,2023-02-14,2023-02-17,0,3
99999.0,62349,3,0,1,1,2023-01-24,2023-03-24,0,59
99999.0,62349,3,3,1,1,2023-01-24,2023-03-24,0,59
99999.0,62349,1,1,1,1,2023-01-24,2023-03-17,0,52
99999.0,62349,5,0,1,1,2023-01-24,2023-02-20,0,27
99999.0,62349,4,4,1,1,2023-01-24,2023-01-31,0,7
99999.0,62349,1,1,1,1,2023-01-24,2023-02-14,0,21
99999.0,62349,1,0,1,1,2023-01-24,2023-01-30,0,6
99999.0,62349,1,1,1,1,2023-01-24,2023-02-17,0,24
99999.0,62349,8,8,1,1,2023-01-24,2023-01-26,0,2
99999.0,62349,5,5,1,1,2023-01-24,2023-02-14,0,21
99999.0,62349,3,0,1,0,2023-01-30,2023-03-24,1,53
99999.0,62349,3,3,1,0,2023-01-30,2023-03-24,1,53
99999.0,62349,1,1,1,0,2023-01-30,2023-03-17,1,46
99999.0,62349,5,0,1,0,2023-01-30,2023-02-20,1,21
99999.0,62349,4,4,1,0,2023-01-30,2023-01-31,1,1
99999.0,62349,1,1,1,0,2023-01-30,2023-02-14,1,15
99999.0,62349,1,1,1,0,2023-01-30,2023-02-17,1,18
99999.0,62349,5,5,1,0,2023-01-30,2023-02-14,1,15
99999.0,62349,3,0,1,1,2023-02-17,2023-03-24,0,35
99999.0,62349,3,3,1,1,2023-02-17,2023-03-24,0,35
99999.0,62349,1,1,1,1,2023-02-17,2023-03-17,0,28
99999.0,62349,5,0,1,1,2023-02-17,2023-02-20,0,3
99999.0,62349,8,8,6,6,2023-01-09,2023-01-26,0,17
99999.0,62349,1,1,1,1,2023-01-17,2023-03-17,0,59
99999.0,62349,5,0,1,1,2023-01-17,2023-02-20,0,34
99999.0,62349,3,3,1,1,2023-01-17,2023-01-19,0,2
99999.0,62349,4,4,1,1,2023-01-17,2023-01-31,0,14
99999.0,62349,1,1,1,1,2023-01-17,2023-02-14,0,28
99999.0,62349,1,1,1,1,2023-01-17,2023-01-24,0,7
99999.0,62349,1,0,1,1,2023-01-17,2023-01-30,0,13
99999.0,62349,1,1,1,1,2023-01-17,2023-02-17,0,31
99999.0,62349,8,8,1,1,2023-01-17,2023-01-26,0,9
99999.0,62349,4,4,1,1,2023-01-17,2023-01-20,0,3
99999.0,62349,5,5,1,1,2023-01-17,2023-02-14,0,28
99999.0,62349,5,0,4,4,2023-01-20,2023-02-20,0,31
99999.0,62349,4,4,4,4,2023-01-20,2023-01-31,0,11
99999.0,62349,8,8,4,4,2023-01-20,2023-01-26,0,6
99999.0,62349,5,5,4,4,2023-01-20,2023-02-14,0,25
99999.0,62349,5,0,5,5,2023-02-14,2023-02-20,0,6
99999.0,62349,5,0,2,2,2023-01-10,2023-02-20,0,41
99999.0,62349,3,3,2,2,2023-01-10,2023-01-19,0,9
99999.0,62349,4,4,2,2,2023-01-10,2023-01-31,0,21
99999.0,62349,8,8,2,2,2023-01-10,2023-01-26,0,16
99999.0,62349,4,4,2,2,2023-01-10,2023-01-20,0,10
99999.0,62349,5,5,2,2,2023-01-10,2023-02-14,0,35
99999.0,82404,384,384,32,32,2022-11-29,2022-12-02,0,3
99999.0,91488,4,4,1,1,2023-01-04,2023-03-03,0,58
99999.0,91488,8,8,1,1,2023-01-04,2023-01-26,0,22
99999.0,91488,8,8,1,1,2023-01-04,2023-01-31,0,27
99999.0,91488,4,4,1,1,2023-01-04,2023-01-11,0,7
99999.0,91488,40,40,1,1,2023-01-04,2023-01-20,0,16
99999.0,91488,6,6,1,1,2023-01-04,2023-01-20,0,16
99999.0,91488,14,14,4,4,2023-03-03,2023-03-06,0,3
99999.0,91488,8,8,8,8,2023-01-26,2023-01-31,0,5
99999.0,91488,14,14,8,8,2023-01-26,2023-03-06,0,39
99999.0,91488,14,14,8,8,2023-01-31,2023-03-06,0,34
99999.0,91488,4,4,4,4,2023-01-11,2023-03-03,0,51
99999.0,91488,8,8,4,4,2023-01-11,2023-01-26,0,15
99999.0,91488,8,8,4,4,2023-01-11,2023-01-31,0,20
99999.0,91488,40,40,4,4,2023-01-11,2023-01-20,0,9
99999.0,91488,14,14,4,4,2023-01-11,2023-03-06,0,54
99999.0,91488,6,6,4,4,2023-01-11,2023-01-20,0,9
99999.0,91488,8,8,6,6,2023-01-20,2023-01-26,0,6
99999.0,91488,8,8,6,6,2023-01-20,2023-01-31,0,11
99999.0,91488,14,14,6,6,2023-01-20,2023-03-06,0,45
99999.0,97403,224,224,32,32,2022-12-25,2023-02-01,0,38
99999.0,97403,64,64,32,32,2022-12-25,2023-02-21,0,58
99999.0,97403,192,192,32,32,2022-12-25,2023-02-07,0,44
99999.0,97403,60,60,32,32,2022-12-25,2023-02-21,0,58
99999.0,97403,192,192,32,32,2022-12-25,2023-02-08,0,45
99999.0,97403,192,192,120,120,2022-10-05,2022-11-23,0,49
99999.0,97403,90,90,80,80,2022-10-11,2022-11-28,0,48
99999.0,97403,192,192,80,80,2022-10-11,2022-11-23,0,43
99999.0,97403,288,288,160,160,2022-09-21,2022-09-28,0,7
99999.0,97403,320,320,160,160,2022-09-21,2022-09-28,0,7
99999.0,97403,32,32,2,0,2022-12-01,2022-12-25,2,24
99999.0,97403,2,2,2,0,2022-12-01,2023-01-18,2,48
99999.0,97403,2,2,2,0,2022-12-01,2023-01-11,2,41
99999.0,97403,2,2,2,0,2022-12-01,2023-01-17,2,47
99999.0,97403,4,4,2,0,2022-12-01,2023-01-04,2,34
99999.0,97403,5,5,2,0,2022-12-01,2023-01-23,2,53
99999.0,97403,10,10,2,0,2022-12-01,2023-01-16,2,46
99999.0,97403,1,0,2,0,2022-12-01,2023-01-03,2,33
99999.0,97403,32,32,14,0,2022-12-01,2022-12-25,14,24
99999.0,97403,2,2,14,0,2022-12-01,2023-01-18,14,48
99999.0,97403,2,2,14,0,2022-12-01,2023-01-11,14,41
99999.0,97403,2,2,14,0,2022-12-01,2023-01-17,14,47
99999.0,97403,4,4,14,0,2022-12-01,2023-01-04,14,34
99999.0,97403,5,5,14,0,2022-12-01,2023-01-23,14,53
99999.0,97403,10,10,14,0,2022-12-01,2023-01-16,14,46
99999.0,97403,1,0,14,0,2022-12-01,2023-01-03,14,33
99999.0,97403,192,192,192,192,2023-02-07,2023-02-08,0,1
99999.0,97403,224,224,2,2,2023-01-18,2023-02-01,0,14
99999.0,97403,64,64,2,2,2023-01-18,2023-02-21,0,34
99999.0,97403,192,192,2,2,2023-01-18,2023-02-07,0,20
99999.0,97403,20,20,2,2,2023-01-18,2023-02-24,0,37
99999.0,97403,4,4,2,2,2023-01-18,2023-03-07,0,48
99999.0,97403,40,40,2,2,2023-01-18,2023-03-08,0,49
99999.0,97403,5,5,2,2,2023-01-18,2023-01-23,0,5
99999.0,97403,13,13,2,2,2023-01-18,2023-01-31,0,13
99999.0,97403,60,60,2,2,2023-01-18,2023-02-21,0,34
99999.0,97403,4,4,2,2,2023-01-18,2023-03-08,0,49
99999.0,97403,10,0,2,2,2023-01-18,2023-03-06,0,47
99999.0,97403,5,5,2,2,2023-01-18,2023-02-17,0,30
99999.0,97403,5,5,2,2,2023-01-18,2023-03-15,0,56
99999.0,97403,192,192,2,2,2023-01-18,2023-02-08,0,21
99999.0,97403,20,20,2,2,2023-01-18,2023-03-01,0,42
99999.0,97403,22,22,2,2,2023-01-18,2023-03-01,0,42
99999.0,97403,224,224,2,2,2023-01-11,2023-02-01,0,21
99999.0,97403,64,64,2,2,2023-01-11,2023-02-21,0,41
99999.0,97403,192,192,2,2,2023-01-11,2023-02-07,0,27
99999.0,97403,2,2,2,2,2023-01-11,2023-01-18,0,7
99999.0,97403,20,20,2,2,2023-01-11,2023-02-24,0,44
99999.0,97403,2,2,2,2,2023-01-11,2023-01-17,0,6
99999.0,97403,4,4,2,2,2023-01-11,2023-03-07,0,55
99999.0,97403,40,40,2,2,2023-01-11,2023-03-08,0,56
99999.0,97403,5,5,2,2,2023-01-11,2023-01-23,0,12
99999.0,97403,13,13,2,2,2023-01-11,2023-01-31,0,20
99999.0,97403,60,60,2,2,2023-01-11,2023-02-21,0,41
99999.0,97403,10,10,2,2,2023-01-11,2023-01-16,0,5
99999.0,97403,4,4,2,2,2023-01-11,2023-03-08,0,56
99999.0,97403,10,0,2,2,2023-01-11,2023-03-06,0,54
99999.0,97403,5,5,2,2,2023-01-11,2023-02-17,0,37
99999.0,97403,192,192,2,2,2023-01-11,2023-02-08,0,28
99999.0,97403,20,20,2,2,2023-01-11,2023-03-01,0,49
99999.0,97403,22,22,2,2,2023-01-11,2023-03-01,0,49
99999.0,97403,40,40,20,20,2023-02-24,2023-03-08,0,12
99999.0,97403,20,20,20,20,2023-02-24,2023-03-01,0,5
99999.0,97403,22,22,20,20,2023-02-24,2023-03-01,0,5
99999.0,97403,224,224,2,2,2023-01-17,2023-02-01,0,15
99999.0,97403,64,64,2,2,2023-01-17,2023-02-21,0,35
99999.0,97403,192,192,2,2,2023-01-17,2023-02-07,0,21
99999.0,97403,2,2,2,2,2023-01-17,2023-01-18,0,1
99999.0,97403,20,20,2,2,2023-01-17,2023-02-24,0,38
99999.0,97403,4,4,2,2,2023-01-17,2023-03-07,0,49
99999.0,97403,40,40,2,2,2023-01-17,2023-03-08,0,50
99999.0,97403,5,5,2,2,2023-01-17,2023-01-23,0,6
99999.0,97403,13,13,2,2,2023-01-17,2023-01-31,0,14
99999.0,97403,60,60,2,2,2023-01-17,2023-02-21,0,35
99999.0,97403,4,4,2,2,2023-01-17,2023-03-08,0,50
99999.0,97403,10,0,2,2,2023-01-17,2023-03-06,0,48
99999.0,97403,5,5,2,2,2023-01-17,2023-02-17,0,31
99999.0,97403,5,5,2,2,2023-01-17,2023-03-15,0,57
99999.0,97403,192,192,2,2,2023-01-17,2023-02-08,0,22
99999.0,97403,20,20,2,2,2023-01-17,2023-03-01,0,43
99999.0,97403,22,22,2,2,2023-01-17,2023-03-01,0,43
99999.0,97403,8,8,4,4,2023-03-07,2023-03-20,0,13
99999.0,97403,40,40,4,4,2023-03-07,2023-03-08,0,1
99999.0,97403,4,4,4,4,2023-03-07,2023-03-08,0,1
99999.0,97403,5,5,4,4,2023-03-07,2023-03-15,0,8
99999.0,97403,224,224,4,4,2023-01-04,2023-02-01,0,28
99999.0,97403,64,64,4,4,2023-01-04,2023-02-21,0,48
99999.0,97403,192,192,4,4,2023-01-04,2023-02-07,0,34
99999.0,97403,20,20,4,4,2023-01-04,2023-02-24,0,51
99999.0,97403,5,5,4,4,2023-01-04,2023-01-23,0,19
99999.0,97403,13,13,4,4,2023-01-04,2023-01-31,0,27
99999.0,97403,60,60,4,4,2023-01-04,2023-02-21,0,48
99999.0,97403,10,10,4,4,2023-01-04,2023-01-16,0,12
99999.0,97403,5,5,4,4,2023-01-04,2023-02-17,0,44
99999.0,97403,192,192,4,4,2023-01-04,2023-02-08,0,35
99999.0,97403,20,20,4,4,2023-01-04,2023-03-01,0,56
99999.0,97403,22,22,4,4,2023-01-04,2023-03-01,0,56
99999.0,97403,224,224,5,5,2023-01-23,2023-02-01,0,9
99999.0,97403,64,64,5,5,2023-01-23,2023-02-21,0,29
99999.0,97403,192,192,5,5,2023-01-23,2023-02-07,0,15
99999.0,97403,8,8,5,5,2023-01-23,2023-03-20,0,56
99999.0,97403,20,20,5,5,2023-01-23,2023-02-24,0,32
99999.0,97403,40,40,5,5,2023-01-23,2023-03-08,0,44
99999.0,97403,13,13,5,5,2023-01-23,2023-01-31,0,8
99999.0,97403,60,60,5,5,2023-01-23,2023-02-21,0,29
99999.0,97403,10,0,5,5,2023-01-23,2023-03-06,0,42
99999.0,97403,5,5,5,5,2023-01-23,2023-02-17,0,25
99999.0,97403,5,5,5,5,2023-01-23,2023-03-15,0,51
99999.0,97403,192,192,5,5,2023-01-23,2023-02-08,0,16
99999.0,97403,20,20,5,5,2023-01-23,2023-03-01,0,37
99999.0,97403,22,22,5,5,2023-01-23,2023-03-01,0,37
99999.0,97403,224,224,13,13,2023-01-31,2023-02-01,0,1
99999.0,97403,64,64,13,13,2023-01-31,2023-02-21,0,21
99999.0,97403,192,192,13,13,2023-01-31,2023-02-07,0,7
99999.0,97403,20,20,13,13,2023-01-31,2023-02-24,0,24
99999.0,97403,40,40,13,13,2023-01-31,2023-03-08,0,36
99999.0,97403,60,60,13,13,2023-01-31,2023-02-21,0,21
99999.0,97403,192,192,13,13,2023-01-31,2023-02-08,0,8
99999.0,97403,20,20,13,13,2023-01-31,2023-03-01,0,29
99999.0,97403,22,22,13,13,2023-01-31,2023-03-01,0,29
99999.0,97403,224,224,10,10,2023-01-16,2023-02-01,0,16
99999.0,97403,64,64,10,10,2023-01-16,2023-02-21,0,36
99999.0,97403,192,192,10,10,2023-01-16,2023-02-07,0,22
99999.0,97403,20,20,10,10,2023-01-16,2023-02-24,0,39
99999.0,97403,40,40,10,10,2023-01-16,2023-03-08,0,51
99999.0,97403,13,13,10,10,2023-01-16,2023-01-31,0,15
99999.0,97403,60,60,10,10,2023-01-16,2023-02-21,0,36
99999.0,97403,10,0,10,10,2023-01-16,2023-03-06,0,49
99999.0,97403,192,192,10,10,2023-01-16,2023-02-08,0,23
99999.0,97403,20,20,10,10,2023-01-16,2023-03-01,0,44
99999.0,97403,22,22,10,10,2023-01-16,2023-03-01,0,44
99999.0,97403,224,224,1,0,2023-01-03,2023-02-01,1,29
99999.0,97403,64,64,1,0,2023-01-03,2023-02-21,1,49
99999.0,97403,192,192,1,0,2023-01-03,2023-02-07,1,35
99999.0,97403,2,2,1,0,2023-01-03,2023-01-18,1,15
99999.0,97403,2,2,1,0,2023-01-03,2023-01-11,1,8
99999.0,97403,20,20,1,0,2023-01-03,2023-02-24,1,52
99999.0,97403,2,2,1,0,2023-01-03,2023-01-17,1,14
99999.0,97403,4,4,1,0,2023-01-03,2023-01-04,1,1
99999.0,97403,5,5,1,0,2023-01-03,2023-01-23,1,20
99999.0,97403,13,13,1,0,2023-01-03,2023-01-31,1,28
99999.0,97403,60,60,1,0,2023-01-03,2023-02-21,1,49
99999.0,97403,10,10,1,0,2023-01-03,2023-01-16,1,13
99999.0,97403,5,5,1,0,2023-01-03,2023-02-17,1,45
99999.0,97403,192,192,1,0,2023-01-03,2023-02-08,1,36
99999.0,97403,20,20,1,0,2023-01-03,2023-03-01,1,57
99999.0,97403,22,22,1,0,2023-01-03,2023-03-01,1,57
99999.0,97403,8,8,4,4,2023-03-08,2023-03-20,0,12
99999.0,97403,5,5,4,4,2023-03-08,2023-03-15,0,7
99999.0,97403,8,8,10,0,2023-03-06,2023-03-20,10,14
99999.0,97403,4,4,10,0,2023-03-06,2023-03-07,10,1
99999.0,97403,40,40,10,0,2023-03-06,2023-03-08,10,2
99999.0,97403,4,4,10,0,2023-03-06,2023-03-08,10,2
99999.0,97403,5,5,10,0,2023-03-06,2023-03-15,10,9
99999.0,97403,64,64,5,5,2023-02-17,2023-02-21,0,4
99999.0,97403,8,8,5,5,2023-02-17,2023-03-20,0,31
99999.0,97403,20,20,5,5,2023-02-17,2023-02-24,0,7
99999.0,97403,40,40,5,5,2023-02-17,2023-03-08,0,19
99999.0,97403,60,60,5,5,2023-02-17,2023-02-21,0,4
99999.0,97403,10,0,5,5,2023-02-17,2023-03-06,0,17
99999.0,97403,5,5,5,5,2023-02-17,2023-03-15,0,26
99999.0,97403,20,20,5,5,2023-02-17,2023-03-01,0,12
99999.0,97403,22,22,5,5,2023-02-17,2023-03-01,0,12
99999.0,97403,8,8,5,5,2023-03-15,2023-03-20,0,5
99999.0,97403,40,40,20,20,2023-03-01,2023-03-08,0,7
99999.0,97403,40,40,22,22,2023-03-01,2023-03-08,0,7
99999.0,221010,1,1,1,1,2023-01-06,2023-01-27,0,21
99999.0,225012,2,2,1,1,2023-01-06,2023-03-07,0,60
99999.0,225012,1,1,1,1,2023-01-06,2023-01-27,0,21
99999.0,225012,20,20,1,1,2023-01-06,2023-01-18,0,12
99999.0,225012,1,1,1,1,2023-01-06,2023-01-26,0,20
99999.0,225012,15,15,1,1,2023-01-06,2023-02-24,0,49
99999.0,225012,1,1,1,1,2023-01-06,2023-03-01,0,54
99999.0,225012,2,2,1,1,2023-01-27,2023-03-07,0,39
99999.0,225012,15,15,1,1,2023-01-27,2023-02-24,0,28
99999.0,225012,1,1,1,1,2023-01-27,2023-03-01,0,33
99999.0,225012,2,2,1,1,2023-01-26,2023-03-07,0,40
99999.0,225012,1,1,1,1,2023-01-26,2023-01-27,0,1
99999.0,225012,15,15,1,1,2023-01-26,2023-02-24,0,29
99999.0,225012,1,1,1,1,2023-01-26,2023-03-01,0,34
99999.0,225012,2,2,1,1,2023-03-01,2023-03-07,0,6
99999.0,233023,2,2,2,2,2022-12-30,2023-01-26,0,27
99999.0,233023,7,7,2,2,2022-12-30,2023-01-26,0,27
99999.0,233023,15,15,2,2,2022-12-30,2023-01-04,0,5
99999.0,233023,5,5,2,2,2023-01-26,2023-03-01,0,34
99999.0,246117,3,3,1,1,2023-01-09,2023-02-24,0,46
99999.0,309170,2,2,2,2,2023-01-05,2023-03-01,0,55
99999.0,309170,2,2,1,1,2023-01-17,2023-03-01,0,43
99999.0,309170,1,1,1,1,2023-01-17,2023-03-06,0,48
99999.0,315094,10,10,10,0,2023-01-12,2023-02-09,10,28
99999.0,315094,10,10,10,10,2023-01-12,2023-02-09,0,28
99999.0,319013,4,4,2,2,2023-01-24,2023-03-06,0,41
99999.0,319013,2,2,2,2,2023-01-04,2023-01-24,0,20
99999.0,319096,1,1,1,1,2023-02-01,2023-03-01,0,28
99999.0,319096,1,1,1,1,2023-01-26,2023-02-01,0,6
99999.0,319096,1,1,1,1,2023-01-26,2023-03-01,0,34
99999.0,328097,1,1,1,1,2022-12-22,2023-01-11,0,20
99999.0,328097,2,2,1,1,2022-12-22,2023-01-05,0,14
99999.0,328097,1,1,1,1,2022-12-22,2023-01-18,0,27
99999.0,328097,4,0,1,1,2022-12-22,2023-01-11,0,20
99999.0,328097,4,4,1,1,2022-12-22,2023-02-09,0,49
99999.0,328097,1,1,1,1,2023-01-11,2023-01-18,0,7
99999.0,328097,4,4,1,1,2023-01-11,2023-02-09,0,29
99999.0,328097,4,0,2,2,2023-01-05,2023-01-11,0,6
99999.0,328097,4,4,2,2,2023-01-05,2023-02-09,0,35
99999.0,328097,4,4,1,1,2023-01-18,2023-02-09,0,22
99999.0,328097,1,1,4,0,2023-01-11,2023-01-18,4,7
99999.0,328097,4,4,4,0,2023-01-11,2023-02-09,4,29
99999.0,365016,10,10,10,10,2023-01-04,2023-01-18,0,14
99999.0,367012,90,90,14,14,2022-12-30,2023-02-21,0,53
99999.0,367012,16,16,14,14,2022-12-30,2023-01-30,0,31
99999.0,367012,100,100,14,14,2022-12-30,2023-01-18,0,19
99999.0,367012,30,30,14,14,2022-12-30,2023-01-04,0,5
99999.0,367012,120,120,14,14,2022-12-30,2023-02-24,0,56
99999.0,367012,14,14,6,6,2022-12-20,2022-12-30,0,10
99999.0,367012,6,6,6,6,2022-12-20,2022-12-22,0,2
99999.0,367012,16,16,6,6,2022-12-20,2023-01-30,0,41
99999.0,367012,12,12,6,6,2022-12-20,2023-01-17,0,28
99999.0,367012,6,6,6,6,2022-12-20,2023-01-03,0,14
99999.0,367012,10,10,6,6,2022-12-20,2023-02-01,0,43
99999.0,367012,100,100,6,6,2022-12-20,2023-01-18,0,29
99999.0,367012,13,13,6,6,2022-12-20,2023-01-26,0,37
99999.0,367012,30,30,6,6,2022-12-20,2023-01-04,0,15
99999.0,367012,12,12,6,6,2022-12-20,2023-02-17,0,59
99999.0,367012,14,14,6,6,2022-12-22,2022-12-30,0,8
99999.0,367012,16,16,6,6,2022-12-22,2023-01-30,0,39
99999.0,367012,12,12,6,6,2022-12-22,2023-01-17,0,26
99999.0,367012,6,6,6,6,2022-12-22,2023-01-03,0,12
99999.0,367012,10,10,6,6,2022-12-22,2023-02-01,0,41
99999.0,367012,100,100,6,6,2022-12-22,2023-01-18,0,27
99999.0,367012,13,13,6,6,2022-12-22,2023-01-26,0,35
99999.0,367012,30,30,6,6,2022-12-22,2023-01-04,0,13
99999.0,367012,12,12,6,6,2022-12-22,2023-02-17,0,57
99999.0,367012,5,0,1,1,2022-10-05,2022-11-09,0,35
99999.0,367012,6,6,1,1,2022-10-05,2022-12-01,0,57
99999.0,367012,14,14,5,0,2022-11-09,2022-12-30,5,51
99999.0,367012,6,6,5,0,2022-11-09,2022-12-20,5,41
99999.0,367012,6,6,5,0,2022-11-09,2022-12-22,5,43
99999.0,367012,6,6,5,0,2022-11-09,2022-12-01,5,22
99999.0,367012,6,6,5,0,2022-11-09,2023-01-03,5,55
99999.0,367012,1,1,5,0,2022-11-09,2023-01-03,5,55
99999.0,367012,30,30,5,0,2022-11-09,2023-01-04,5,56
99999.0,367012,14,14,6,6,2022-12-01,2022-12-30,0,29
99999.0,367012,6,6,6,6,2022-12-01,2022-12-20,0,19
99999.0,367012,6,6,6,6,2022-12-01,2022-12-22,0,21
99999.0,367012,16,16,6,6,2022-12-01,2023-01-30,0,60
99999.0,367012,12,12,6,6,2022-12-01,2023-01-17,0,47
99999.0,367012,6,6,6,6,2022-12-01,2023-01-03,0,33
99999.0,367012,100,100,6,6,2022-12-01,2023-01-18,0,48
99999.0,367012,13,13,6,6,2022-12-01,2023-01-26,0,56
99999.0,367012,30,30,6,6,2022-12-01,2023-01-04,0,34
99999.0,367012,120,120,90,90,2023-02-21,2023-02-24,0,3
99999.0,367012,90,90,1,1,2023-02-14,2023-02-21,0,7
99999.0,367012,3,3,1,1,2023-02-14,2023-02-24,0,10
99999.0,367012,7,7,1,1,2023-02-14,2023-03-24,0,38
99999.0,367012,4,4,1,1,2023-02-14,2023-03-10,0,24
99999.0,367012,6,6,1,1,2023-02-14,2023-03-15,0,29
99999.0,367012,16,16,1,1,2023-02-14,2023-03-06,0,20
99999.0,367012,6,6,1,1,2023-02-14,2023-02-23,0,9
99999.0,367012,15,15,1,1,2023-02-14,2023-03-01,0,15
99999.0,367012,17,17,1,1,2023-02-14,2023-03-01,0,15
99999.0,367012,3,3,1,1,2023-02-14,2023-03-16,0,30
99999.0,367012,4,0,1,1,2023-02-14,2023-03-06,0,20
99999.0,367012,12,12,1,1,2023-02-14,2023-02-17,0,3
99999.0,367012,1,0,1,1,2023-02-14,2023-02-23,0,9
99999.0,367012,120,120,1,1,2023-02-14,2023-02-24,0,10
99999.0,367012,1,1,1,1,2023-02-14,2023-03-16,0,30
99999.0,367012,1,1,1,1,2023-02-14,2023-02-24,0,10
99999.0,367012,90,90,2,2,2023-01-27,2023-02-21,0,25
99999.0,367012,3,3,2,2,2023-01-27,2023-02-24,0,28
99999.0,367012,16,16,2,2,2023-01-27,2023-01-30,0,3
99999.0,367012,7,7,2,2,2023-01-27,2023-03-24,0,56
99999.0,367012,2,2,2,2,2023-01-27,2023-02-06,0,10
99999.0,367012,4,4,2,2,2023-01-27,2023-03-10,0,42
99999.0,367012,10,10,2,2,2023-01-27,2023-02-01,0,5
99999.0,367012,6,6,2,2,2023-01-27,2023-03-15,0,47
99999.0,367012,16,16,2,2,2023-01-27,2023-03-06,0,38
99999.0,367012,6,6,2,2,2023-01-27,2023-02-23,0,27
99999.0,367012,15,15,2,2,2023-01-27,2023-03-01,0,33
99999.0,367012,17,17,2,2,2023-01-27,2023-03-01,0,33
99999.0,367012,3,3,2,2,2023-01-27,2023-03-16,0,48
99999.0,367012,4,0,2,2,2023-01-27,2023-03-06,0,38
99999.0,367012,12,12,2,2,2023-01-27,2023-02-17,0,21
99999.0,367012,120,120,2,2,2023-01-27,2023-02-24,0,28
99999.0,367012,90,90,4,4,2023-01-24,2023-02-21,0,28
99999.0,367012,16,16,4,4,2023-01-24,2023-01-30,0,6
99999.0,367012,7,7,4,4,2023-01-24,2023-03-24,0,59
99999.0,367012,4,4,4,4,2023-01-24,2023-03-10,0,45
99999.0,367012,10,10,4,4,2023-01-24,2023-02-01,0,8
99999.0,367012,6,6,4,4,2023-01-24,2023-03-15,0,50
99999.0,367012,16,16,4,4,2023-01-24,2023-03-06,0,41
99999.0,367012,6,6,4,4,2023-01-24,2023-02-23,0,30
99999.0,367012,15,15,4,4,2023-01-24,2023-03-01,0,36
99999.0,367012,17,17,4,4,2023-01-24,2023-03-01,0,36
99999.0,367012,13,13,4,4,2023-01-24,2023-01-26,0,2
99999.0,367012,4,0,4,4,2023-01-24,2023-03-06,0,41
99999.0,367012,12,12,4,4,2023-01-24,2023-02-17,0,24
99999.0,367012,120,120,4,4,2023-01-24,2023-02-24,0,31
99999.0,367012,90,90,1,1,2023-01-30,2023-02-21,0,22
99999.0,367012,1,1,1,1,2023-01-30,2023-02-14,0,15
99999.0,367012,3,3,1,1,2023-01-30,2023-02-24,0,25
99999.0,367012,7,7,1,1,2023-01-30,2023-03-24,0,53
99999.0,367012,2,2,1,1,2023-01-30,2023-02-06,0,7
99999.0,367012,4,4,1,1,2023-01-30,2023-03-10,0,39
99999.0,367012,10,10,1,1,2023-01-30,2023-02-01,0,2
99999.0,367012,6,6,1,1,2023-01-30,2023-03-15,0,44
99999.0,367012,16,16,1,1,2023-01-30,2023-03-06,0,35
99999.0,367012,6,6,1,1,2023-01-30,2023-02-23,0,24
99999.0,367012,15,15,1,1,2023-01-30,2023-03-01,0,30
99999.0,367012,17,17,1,1,2023-01-30,2023-03-01,0,30
99999.0,367012,3,3,1,1,2023-01-30,2023-03-16,0,45
99999.0,367012,4,0,1,1,2023-01-30,2023-03-06,0,35
99999.0,367012,12,12,1,1,2023-01-30,2023-02-17,0,18
99999.0,367012,1,0,1,1,2023-01-30,2023-02-23,0,24
99999.0,367012,120,120,1,1,2023-01-30,2023-02-24,0,25
99999.0,367012,1,1,1,1,2023-01-30,2023-03-16,0,45
99999.0,367012,1,1,1,1,2023-01-30,2023-02-24,0,25
99999.0,367012,7,7,3,3,2023-02-24,2023-03-24,0,28
99999.0,367012,4,4,3,3,2023-02-24,2023-03-10,0,14
99999.0,367012,6,6,3,3,2023-02-24,2023-03-15,0,19
99999.0,367012,16,16,3,3,2023-02-24,2023-03-06,0,10
99999.0,367012,15,15,3,3,2023-02-24,2023-03-01,0,5
99999.0,367012,17,17,3,3,2023-02-24,2023-03-01,0,5
99999.0,367012,3,3,3,3,2023-02-24,2023-03-16,0,20
99999.0,367012,4,0,3,3,2023-02-24,2023-03-06,0,10
99999.0,367012,90,90,4,4,2023-01-17,2023-02-21,0,35
99999.0,367012,4,4,4,4,2023-01-17,2023-01-24,0,7
99999.0,367012,16,16,4,4,2023-01-17,2023-01-30,0,13
99999.0,367012,4,4,4,4,2023-01-17,2023-03-10,0,52
99999.0,367012,10,10,4,4,2023-01-17,2023-02-01,0,15
99999.0,367012,6,6,4,4,2023-01-17,2023-03-15,0,57
99999.0,367012,16,16,4,4,2023-01-17,2023-03-06,0,48
99999.0,367012,6,6,4,4,2023-01-17,2023-02-23,0,37
99999.0,367012,15,15,4,4,2023-01-17,2023-03-01,0,43
99999.0,367012,17,17,4,4,2023-01-17,2023-03-01,0,43
99999.0,367012,100,100,4,4,2023-01-17,2023-01-18,0,1
99999.0,367012,13,13,4,4,2023-01-17,2023-01-26,0,9
99999.0,367012,4,0,4,4,2023-01-17,2023-03-06,0,48
99999.0,367012,12,12,4,4,2023-01-17,2023-02-17,0,31
99999.0,367012,120,120,4,4,2023-01-17,2023-02-24,0,38
99999.0,367012,90,90,16,16,2023-01-30,2023-02-21,0,22
99999.0,367012,16,16,16,16,2023-01-30,2023-03-06,0,35
99999.0,367012,17,17,16,16,2023-01-30,2023-03-01,0,30
99999.0,367012,120,120,16,16,2023-01-30,2023-02-24,0,25
99999.0,367012,90,90,2,2,2023-02-06,2023-02-21,0,15
99999.0,367012,3,3,2,2,2023-02-06,2023-02-24,0,18
99999.0,367012,7,7,2,2,2023-02-06,2023-03-24,0,46
99999.0,367012,4,4,2,2,2023-02-06,2023-03-10,0,32
99999.0,367012,6,6,2,2,2023-02-06,2023-03-15,0,37
99999.0,367012,16,16,2,2,2023-02-06,2023-03-06,0,28
99999.0,367012,6,6,2,2,2023-02-06,2023-02-23,0,17
99999.0,367012,15,15,2,2,2023-02-06,2023-03-01,0,23
99999.0,367012,17,17,2,2,2023-02-06,2023-03-01,0,23
99999.0,367012,3,3,2,2,2023-02-06,2023-03-16,0,38
99999.0,367012,4,0,2,2,2023-02-06,2023-03-06,0,28
99999.0,367012,12,12,2,2,2023-02-06,2023-02-17,0,11
99999.0,367012,120,120,2,2,2023-02-06,2023-02-24,0,18
99999.0,367012,90,90,12,12,2023-01-17,2023-02-21,0,35
99999.0,367012,16,16,12,12,2023-01-17,2023-01-30,0,13
99999.0,367012,16,16,12,12,2023-01-17,2023-03-06,0,48
99999.0,367012,15,15,12,12,2023-01-17,2023-03-01,0,43
99999.0,367012,17,17,12,12,2023-01-17,2023-03-01,0,43
99999.0,367012,100,100,12,12,2023-01-17,2023-01-18,0,1
99999.0,367012,13,13,12,12,2023-01-17,2023-01-26,0,9
99999.0,367012,12,12,12,12,2023-01-17,2023-02-17,0,31
99999.0,367012,120,120,12,12,2023-01-17,2023-02-24,0,38
99999.0,367012,90,90,6,6,2023-01-03,2023-02-21,0,49
99999.0,367012,16,16,6,6,2023-01-03,2023-01-30,0,27
99999.0,367012,12,12,6,6,2023-01-03,2023-01-17,0,14
99999.0,367012,10,10,6,6,2023-01-03,2023-02-01,0,29
99999.0,367012,6,6,6,6,2023-01-03,2023-02-23,0,51
99999.0,367012,15,15,6,6,2023-01-03,2023-03-01,0,57
99999.0,367012,17,17,6,6,2023-01-03,2023-03-01,0,57
99999.0,367012,100,100,6,6,2023-01-03,2023-01-18,0,15
99999.0,367012,13,13,6,6,2023-01-03,2023-01-26,0,23
99999.0,367012,30,30,6,6,2023-01-03,2023-01-04,0,1
99999.0,367012,12,12,6,6,2023-01-03,2023-02-17,0,45
99999.0,367012,120,120,6,6,2023-01-03,2023-02-24,0,52
99999.0,367012,7,7,4,4,2023-03-10,2023-03-24,0,14
99999.0,367012,6,6,4,4,2023-03-10,2023-03-15,0,5
99999.0,367012,90,90,10,10,2023-02-01,2023-02-21,0,20
99999.0,367012,16,16,10,10,2023-02-01,2023-03-06,0,33
99999.0,367012,15,15,10,10,2023-02-01,2023-03-01,0,28
99999.0,367012,17,17,10,10,2023-02-01,2023-03-01,0,28
99999.0,367012,12,12,10,10,2023-02-01,2023-02-17,0,16
99999.0,367012,120,120,10,10,2023-02-01,2023-02-24,0,23
99999.0,367012,7,7,6,6,2023-03-15,2023-03-24,0,9
99999.0,367012,90,90,1,1,2023-01-27,2023-02-21,0,25
99999.0,367012,1,1,1,1,2023-01-27,2023-02-14,0,18
99999.0,367012,1,1,1,1,2023-01-27,2023-01-30,0,3
99999.0,367012,3,3,1,1,2023-01-27,2023-02-24,0,28
99999.0,367012,16,16,1,1,2023-01-27,2023-01-30,0,3
99999.0,367012,7,7,1,1,2023-01-27,2023-03-24,0,56
99999.0,367012,2,2,1,1,2023-01-27,2023-02-06,0,10
99999.0,367012,4,4,1,1,2023-01-27,2023-03-10,0,42
99999.0,367012,10,10,1,1,2023-01-27,2023-02-01,0,5
99999.0,367012,6,6,1,1,2023-01-27,2023-03-15,0,47
99999.0,367012,16,16,1,1,2023-01-27,2023-03-06,0,38
99999.0,367012,6,6,1,1,2023-01-27,2023-02-23,0,27
99999.0,367012,15,15,1,1,2023-01-27,2023-03-01,0,33
99999.0,367012,17,17,1,1,2023-01-27,2023-03-01,0,33
99999.0,367012,3,3,1,1,2023-01-27,2023-03-16,0,48
99999.0,367012,4,0,1,1,2023-01-27,2023-03-06,0,38
99999.0,367012,12,12,1,1,2023-01-27,2023-02-17,0,21
99999.0,367012,1,0,1,1,2023-01-27,2023-02-23,0,27
99999.0,367012,120,120,1,1,2023-01-27,2023-02-24,0,28
99999.0,367012,1,1,1,1,2023-01-27,2023-03-16,0,48
99999.0,367012,1,1,1,1,2023-01-27,2023-02-24,0,28
99999.0,367012,7,7,6,6,2023-02-23,2023-03-24,0,29
99999.0,367012,6,6,6,6,2023-02-23,2023-03-15,0,20
99999.0,367012,16,16,6,6,2023-02-23,2023-03-06,0,11
99999.0,367012,15,15,6,6,2023-02-23,2023-03-01,0,6
99999.0,367012,17,17,6,6,2023-02-23,2023-03-01,0,6
99999.0,367012,120,120,6,6,2023-02-23,2023-02-24,0,1
99999.0,367012,16,16,15,15,2023-03-01,2023-03-06,0,5
99999.0,367012,7,7,3,3,2023-03-16,2023-03-24,0,8
99999.0,367012,120,120,100,100,2023-01-18,2023-02-24,0,37
99999.0,367012,90,90,1,1,2023-01-26,2023-02-21,0,26
99999.0,367012,1,1,1,1,2023-01-26,2023-02-14,0,19
99999.0,367012,2,2,1,1,2023-01-26,2023-01-27,0,1
99999.0,367012,1,1,1,1,2023-01-26,2023-01-30,0,4
99999.0,367012,3,3,1,1,2023-01-26,2023-02-24,0,29
99999.0,367012,16,16,1,1,2023-01-26,2023-01-30,0,4
99999.0,367012,7,7,1,1,2023-01-26,2023-03-24,0,57
99999.0,367012,2,2,1,1,2023-01-26,2023-02-06,0,11
99999.0,367012,4,4,1,1,2023-01-26,2023-03-10,0,43
99999.0,367012,10,10,1,1,2023-01-26,2023-02-01,0,6
99999.0,367012,6,6,1,1,2023-01-26,2023-03-15,0,48
99999.0,367012,16,16,1,1,2023-01-26,2023-03-06,0,39
99999.0,367012,1,1,1,1,2023-01-26,2023-01-27,0,1
99999.0,367012,6,6,1,1,2023-01-26,2023-02-23,0,28
99999.0,367012,15,15,1,1,2023-01-26,2023-03-01,0,34
99999.0,367012,17,17,1,1,2023-01-26,2023-03-01,0,34
99999.0,367012,3,3,1,1,2023-01-26,2023-03-16,0,49
99999.0,367012,4,0,1,1,2023-01-26,2023-03-06,0,39
99999.0,367012,12,12,1,1,2023-01-26,2023-02-17,0,22
99999.0,367012,1,0,1,1,2023-01-26,2023-02-23,0,28
99999.0,367012,120,120,1,1,2023-01-26,2023-02-24,0,29
99999.0,367012,1,1,1,1,2023-01-26,2023-03-16,0,49
99999.0,367012,1,1,1,1,2023-01-26,2023-02-24,0,29
99999.0,367012,90,90,13,13,2023-01-26,2023-02-21,0,26
99999.0,367012,16,16,13,13,2023-01-26,2023-01-30,0,4
99999.0,367012,16,16,13,13,2023-01-26,2023-03-06,0,39
99999.0,367012,15,15,13,13,2023-01-26,2023-03-01,0,34
99999.0,367012,17,17,13,13,2023-01-26,2023-03-01,0,34
99999.0,367012,120,120,13,13,2023-01-26,2023-02-24,0,29
99999.0,367012,90,90,5,5,2023-01-12,2023-02-21,0,40
99999.0,367012,16,16,5,5,2023-01-12,2023-01-30,0,18
99999.0,367012,12,12,5,5,2023-01-12,2023-01-17,0,5
99999.0,367012,10,10,5,5,2023-01-12,2023-02-01,0,20
99999.0,367012,16,16,5,5,2023-01-12,2023-03-06,0,53
99999.0,367012,6,6,5,5,2023-01-12,2023-02-23,0,42
99999.0,367012,15,15,5,5,2023-01-12,2023-03-01,0,48
99999.0,367012,17,17,5,5,2023-01-12,2023-03-01,0,48
99999.0,367012,100,100,5,5,2023-01-12,2023-01-18,0,6
99999.0,367012,13,13,5,5,2023-01-12,2023-01-26,0,14
99999.0,367012,12,12,5,5,2023-01-12,2023-02-17,0,36
99999.0,367012,120,120,5,5,2023-01-12,2023-02-24,0,43
99999.0,367012,90,90,1,1,2023-01-03,2023-02-21,0,49
99999.0,367012,1,1,1,1,2023-01-03,2023-02-14,0,42
99999.0,367012,2,2,1,1,2023-01-03,2023-01-27,0,24
99999.0,367012,4,4,1,1,2023-01-03,2023-01-24,0,21
99999.0,367012,1,1,1,1,2023-01-03,2023-01-30,0,27
99999.0,367012,3,3,1,1,2023-01-03,2023-02-24,0,52
99999.0,367012,4,4,1,1,2023-01-03,2023-01-17,0,14
99999.0,367012,16,16,1,1,2023-01-03,2023-01-30,0,27
99999.0,367012,2,2,1,1,2023-01-03,2023-02-06,0,34
99999.0,367012,12,12,1,1,2023-01-03,2023-01-17,0,14
99999.0,367012,10,10,1,1,2023-01-03,2023-02-01,0,29
99999.0,367012,1,1,1,1,2023-01-03,2023-01-27,0,24
99999.0,367012,6,6,1,1,2023-01-03,2023-02-23,0,51
99999.0,367012,15,15,1,1,2023-01-03,2023-03-01,0,57
99999.0,367012,17,17,1,1,2023-01-03,2023-03-01,0,57
99999.0,367012,100,100,1,1,2023-01-03,2023-01-18,0,15
99999.0,367012,1,1,1,1,2023-01-03,2023-01-26,0,23
99999.0,367012,13,13,1,1,2023-01-03,2023-01-26,0,23
99999.0,367012,5,5,1,1,2023-01-03,2023-01-12,0,9
99999.0,367012,30,30,1,1,2023-01-03,2023-01-04,0,1
99999.0,367012,3,0,1,1,2023-01-03,2023-01-12,0,9
99999.0,367012,3,3,1,1,2023-01-03,2023-01-12,0,9
99999.0,367012,12,12,1,1,2023-01-03,2023-02-17,0,45
99999.0,367012,1,0,1,1,2023-01-03,2023-02-23,0,51
99999.0,367012,120,120,1,1,2023-01-03,2023-02-24,0,52
99999.0,367012,1,1,1,1,2023-01-03,2023-02-24,0,52
99999.0,367012,90,90,30,30,2023-01-04,2023-02-21,0,48
99999.0,367012,100,100,30,30,2023-01-04,2023-01-18,0,14
99999.0,367012,120,120,30,30,2023-01-04,2023-02-24,0,51
99999.0,367012,7,7,4,0,2023-03-06,2023-03-24,4,18
99999.0,367012,4,4,4,0,2023-03-06,2023-03-10,4,4
99999.0,367012,6,6,4,0,2023-03-06,2023-03-15,4,9
99999.0,367012,3,3,4,0,2023-03-06,2023-03-16,4,10
99999.0,367012,1,1,4,0,2023-03-06,2023-03-16,4,10
99999.0,367012,90,90,3,0,2023-01-12,2023-02-21,3,40
99999.0,367012,1,1,3,0,2023-01-12,2023-02-14,3,33
99999.0,367012,2,2,3,0,2023-01-12,2023-01-27,3,15
99999.0,367012,4,4,3,0,2023-01-12,2023-01-24,3,12
99999.0,367012,1,1,3,0,2023-01-12,2023-01-30,3,18
99999.0,367012,3,3,3,0,2023-01-12,2023-02-24,3,43
99999.0,367012,4,4,3,0,2023-01-12,2023-01-17,3,5
99999.0,367012,16,16,3,0,2023-01-12,2023-01-30,3,18
99999.0,367012,2,2,3,0,2023-01-12,2023-02-06,3,25
99999.0,367012,12,12,3,0,2023-01-12,2023-01-17,3,5
99999.0,367012,4,4,3,0,2023-01-12,2023-03-10,3,57
99999.0,367012,10,10,3,0,2023-01-12,2023-02-01,3,20
99999.0,367012,16,16,3,0,2023-01-12,2023-03-06,3,53
99999.0,367012,1,1,3,0,2023-01-12,2023-01-27,3,15
99999.0,367012,6,6,3,0,2023-01-12,2023-02-23,3,42
99999.0,367012,15,15,3,0,2023-01-12,2023-03-01,3,48
99999.0,367012,17,17,3,0,2023-01-12,2023-03-01,3,48
99999.0,367012,100,100,3,0,2023-01-12,2023-01-18,3,6
99999.0,367012,1,1,3,0,2023-01-12,2023-01-26,3,14
99999.0,367012,13,13,3,0,2023-01-12,2023-01-26,3,14
99999.0,367012,4,0,3,0,2023-01-12,2023-03-06,3,53
99999.0,367012,12,12,3,0,2023-01-12,2023-02-17,3,36
99999.0,367012,1,0,3,0,2023-01-12,2023-02-23,3,42
99999.0,367012,120,120,3,0,2023-01-12,2023-02-24,3,43
99999.0,367012,1,1,3,0,2023-01-12,2023-02-24,3,43
99999.0,367012,90,90,3,3,2023-01-12,2023-02-21,0,40
99999.0,367012,4,4,3,3,2023-01-12,2023-01-24,0,12
99999.0,367012,3,3,3,3,2023-01-12,2023-02-24,0,43
99999.0,367012,4,4,3,3,2023-01-12,2023-01-17,0,5
99999.0,367012,16,16,3,3,2023-01-12,2023-01-30,0,18
99999.0,367012,12,12,3,3,2023-01-12,2023-01-17,0,5
99999.0,367012,4,4,3,3,2023-01-12,2023-03-10,0,57
99999.0,367012,10,10,3,3,2023-01-12,2023-02-01,0,20
99999.0,367012,16,16,3,3,2023-01-12,2023-03-06,0,53
99999.0,367012,6,6,3,3,2023-01-12,2023-02-23,0,42
99999.0,367012,15,15,3,3,2023-01-12,2023-03-01,0,48
99999.0,367012,17,17,3,3,2023-01-12,2023-03-01,0,48
99999.0,367012,100,100,3,3,2023-01-12,2023-01-18,0,6
99999.0,367012,13,13,3,3,2023-01-12,2023-01-26,0,14
99999.0,367012,4,0,3,3,2023-01-12,2023-03-06,0,53
99999.0,367012,12,12,3,3,2023-01-12,2023-02-17,0,36
99999.0,367012,120,120,3,3,2023-01-12,2023-02-24,0,43
99999.0,367012,90,90,12,12,2023-02-17,2023-02-21,0,4
99999.0,367012,16,16,12,12,2023-02-17,2023-03-06,0,17
99999.0,367012,15,15,12,12,2023-02-17,2023-03-01,0,12
99999.0,367012,17,17,12,12,2023-02-17,2023-03-01,0,12
99999.0,367012,120,120,12,12,2023-02-17,2023-02-24,0,7
99999.0,367012,3,3,1,0,2023-02-23,2023-02-24,1,1
99999.0,367012,7,7,1,0,2023-02-23,2023-03-24,1,29
99999.0,367012,4,4,1,0,2023-02-23,2023-03-10,1,15
99999.0,367012,6,6,1,0,2023-02-23,2023-03-15,1,20
99999.0,367012,16,16,1,0,2023-02-23,2023-03-06,1,11
99999.0,367012,15,15,1,0,2023-02-23,2023-03-01,1,6
99999.0,367012,17,17,1,0,2023-02-23,2023-03-01,1,6
99999.0,367012,3,3,1,0,2023-02-23,2023-03-16,1,21
99999.0,367012,4,0,1,0,2023-02-23,2023-03-06,1,11
99999.0,367012,120,120,1,0,2023-02-23,2023-02-24,1,1
99999.0,367012,1,1,1,0,2023-02-23,2023-03-16,1,21
99999.0,367012,1,1,1,0,2023-02-23,2023-02-24,1,1
99999.0,367012,7,7,1,1,2023-03-16,2023-03-24,0,8
99999.0,367012,7,7,1,1,2023-02-24,2023-03-24,0,28
99999.0,367012,4,4,1,1,2023-02-24,2023-03-10,0,14
99999.0,367012,6,6,1,1,2023-02-24,2023-03-15,0,19
99999.0,367012,16,16,1,1,2023-02-24,2023-03-06,0,10
99999.0,367012,15,15,1,1,2023-02-24,2023-03-01,0,5
99999.0,367012,17,17,1,1,2023-02-24,2023-03-01,0,5
99999.0,367012,3,3,1,1,2023-02-24,2023-03-16,0,20
99999.0,367012,4,0,1,1,2023-02-24,2023-03-06,0,10
99999.0,367012,1,1,1,1,2023-02-24,2023-03-16,0,20
99999.0,369018,20,20,4,4,2022-12-30,2023-02-21,0,53
99999.0,369018,16,16,4,4,2022-12-30,2023-02-24,0,56
99999.0,369018,20,20,1,1,2023-01-05,2023-02-21,0,47
99999.0,369018,16,16,1,1,2023-01-05,2023-02-24,0,50
99999.0,369026,3,3,2,2,2022-12-22,2023-01-31,0,40
99999.0,369026,2,2,2,2,2022-12-22,2023-01-17,0,26
99999.0,369026,10,10,2,2,2022-12-22,2023-01-18,0,27
99999.0,369026,5,5,2,2,2022-12-22,2023-01-04,0,13
99999.0,369026,40,40,30,30,2023-02-21,2023-02-24,0,3
99999.0,369026,30,30,3,3,2023-01-31,2023-02-21,0,21
99999.0,369026,24,24,3,3,2023-01-31,2023-03-02,0,30
99999.0,369026,40,40,3,3,2023-01-31,2023-02-24,0,24
99999.0,369026,30,30,2,2,2023-01-17,2023-02-21,0,35
99999.0,369026,3,3,2,2,2023-01-17,2023-01-31,0,14
99999.0,369026,10,10,2,2,2023-01-17,2023-01-18,0,1
99999.0,369026,24,24,2,2,2023-01-17,2023-03-02,0,44
99999.0,369026,40,40,2,2,2023-01-17,2023-02-24,0,38
99999.0,369026,30,30,10,10,2023-01-18,2023-02-21,0,34
99999.0,369026,24,24,10,10,2023-01-18,2023-03-02,0,43
99999.0,369026,40,40,10,10,2023-01-18,2023-02-24,0,37
99999.0,369026,30,30,5,5,2023-01-04,2023-02-21,0,48
99999.0,369026,10,10,5,5,2023-01-04,2023-01-18,0,14
99999.0,369026,24,24,5,5,2023-01-04,2023-03-02,0,57
99999.0,369026,40,40,5,5,2023-01-04,2023-02-24,0,51
99999.0,373019,3,3,2,2,2022-12-30,2023-02-24,0,56
99999.0,373019,2,2,2,2,2022-12-30,2023-02-01,0,33
99999.0,373019,20,20,2,2,2022-12-30,2023-01-04,0,5
99999.0,373019,70,70,2,2,2022-12-30,2023-02-24,0,56
99999.0,373019,5,5,3,3,2023-02-24,2023-03-01,0,5
99999.0,373019,3,3,2,2,2023-02-01,2023-02-24,0,23
99999.0,373019,5,5,2,2,2023-02-01,2023-03-01,0,28
99999.0,373019,2,2,2,2,2023-02-01,2023-03-06,0,33
99999.0,373019,70,70,2,2,2023-02-01,2023-02-24,0,23
99999.0,373019,3,3,1,1,2023-01-27,2023-02-24,0,28
99999.0,373019,2,2,1,1,2023-01-27,2023-02-01,0,5
99999.0,373019,1,1,1,1,2023-01-27,2023-03-15,0,47
99999.0,373019,5,5,1,1,2023-01-27,2023-03-01,0,33
99999.0,373019,2,2,1,1,2023-01-27,2023-03-06,0,38
99999.0,373019,70,70,1,1,2023-01-27,2023-02-24,0,28
99999.0,373019,3,3,1,1,2023-01-26,2023-02-24,0,29
99999.0,373019,2,2,1,1,2023-01-26,2023-02-01,0,6
99999.0,373019,1,1,1,1,2023-01-26,2023-03-15,0,48
99999.0,373019,1,1,1,1,2023-01-26,2023-01-27,0,1
99999.0,373019,5,5,1,1,2023-01-26,2023-03-01,0,34
99999.0,373019,2,2,1,1,2023-01-26,2023-03-06,0,39
99999.0,373019,70,70,1,1,2023-01-26,2023-02-24,0,29
99999.0,373019,3,3,1,1,2023-01-26,2023-02-24,0,29
99999.0,373019,2,2,1,1,2023-01-26,2023-02-01,0,6
99999.0,373019,1,1,1,1,2023-01-26,2023-03-15,0,48
99999.0,373019,1,1,1,1,2023-01-26,2023-01-27,0,1
99999.0,373019,5,5,1,1,2023-01-26,2023-03-01,0,34
99999.0,373019,2,2,1,1,2023-01-26,2023-03-06,0,39
99999.0,373019,70,70,1,1,2023-01-26,2023-02-24,0,29
99999.0,373019,3,3,1,1,2023-01-03,2023-02-24,0,52
99999.0,373019,2,2,1,1,2023-01-03,2023-02-01,0,29
99999.0,373019,1,1,1,1,2023-01-03,2023-01-27,0,24
99999.0,373019,5,5,1,1,2023-01-03,2023-03-01,0,57
99999.0,373019,1,1,1,1,2023-01-03,2023-01-26,0,23
99999.0,373019,1,1,1,1,2023-01-03,2023-01-26,0,23
99999.0,373019,20,20,1,1,2023-01-03,2023-01-04,0,1
99999.0,373019,70,70,1,1,2023-01-03,2023-02-24,0,52
99999.0,373019,70,70,20,20,2023-01-04,2023-02-24,0,51
99999.0,374025,2,2,2,2,2022-12-30,2023-01-24,0,25
99999.0,374025,3,3,2,2,2022-12-30,2023-01-03,0,4
99999.0,374025,3,3,2,2,2022-12-30,2023-01-30,0,31
99999.0,374025,3,3,2,2,2022-12-30,2023-02-01,0,33
99999.0,374025,2,2,2,2,2022-12-30,2023-01-23,0,24
99999.0,374025,15,15,2,2,2022-12-30,2023-01-18,0,19
99999.0,374025,3,3,2,2,2022-12-30,2023-01-10,0,11
99999.0,374025,4,4,2,2,2022-12-30,2023-01-04,0,5
99999.0,374025,30,30,2,2,2022-12-30,2023-02-24,0,56
99999.0,374025,3,3,2,2,2023-01-24,2023-01-30,0,6
99999.0,374025,3,3,2,2,2023-01-24,2023-02-01,0,8
99999.0,374025,3,3,2,2,2023-01-24,2023-03-01,0,36
99999.0,374025,30,30,2,2,2023-01-24,2023-02-24,0,31
99999.0,374025,2,2,1,1,2023-01-06,2023-01-24,0,18
99999.0,374025,1,1,1,1,2023-01-06,2023-02-24,0,49
99999.0,374025,3,3,1,1,2023-01-06,2023-01-30,0,24
99999.0,374025,3,3,1,1,2023-01-06,2023-02-01,0,26
99999.0,374025,1,1,1,1,2023-01-06,2023-01-23,0,17
99999.0,374025,2,2,1,1,2023-01-06,2023-01-23,0,17
99999.0,374025,1,1,1,1,2023-01-06,2023-01-27,0,21
99999.0,374025,3,3,1,1,2023-01-06,2023-03-01,0,54
99999.0,374025,15,15,1,1,2023-01-06,2023-01-18,0,12
99999.0,374025,1,1,1,1,2023-01-06,2023-01-26,0,20
99999.0,374025,3,3,1,1,2023-01-06,2023-01-10,0,4
99999.0,374025,30,30,1,1,2023-01-06,2023-02-24,0,49
99999.0,374025,3,3,3,3,2023-01-03,2023-01-30,0,27
99999.0,374025,3,3,3,3,2023-01-03,2023-02-01,0,29
99999.0,374025,3,3,3,3,2023-01-03,2023-03-01,0,57
99999.0,374025,15,15,3,3,2023-01-03,2023-01-18,0,15
99999.0,374025,3,3,3,3,2023-01-03,2023-01-10,0,7
99999.0,374025,4,4,3,3,2023-01-03,2023-01-04,0,1
99999.0,374025,30,30,3,3,2023-01-03,2023-02-24,0,52
99999.0,374025,3,3,1,1,2023-02-24,2023-03-01,0,5
99999.0,374025,3,3,3,3,2023-01-30,2023-02-01,0,2
99999.0,374025,3,3,3,3,2023-01-30,2023-03-01,0,30
99999.0,374025,30,30,3,3,2023-01-30,2023-02-24,0,25
99999.0,374025,3,3,3,3,2023-02-01,2023-03-01,0,28
99999.0,374025,30,30,3,3,2023-02-01,2023-02-24,0,23
99999.0,374025,2,2,1,1,2023-01-23,2023-01-24,0,1
99999.0,374025,1,1,1,1,2023-01-23,2023-02-24,0,32
99999.0,374025,3,3,1,1,2023-01-23,2023-01-30,0,7
99999.0,374025,3,3,1,1,2023-01-23,2023-02-01,0,9
99999.0,374025,1,1,1,1,2023-01-23,2023-01-27,0,4
99999.0,374025,3,3,1,1,2023-01-23,2023-03-01,0,37
99999.0,374025,1,1,1,1,2023-01-23,2023-01-26,0,3
99999.0,374025,30,30,1,1,2023-01-23,2023-02-24,0,32
99999.0,374025,2,2,2,2,2023-01-23,2023-01-24,0,1
99999.0,374025,3,3,2,2,2023-01-23,2023-01-30,0,7
99999.0,374025,3,3,2,2,2023-01-23,2023-02-01,0,9
99999.0,374025,3,3,2,2,2023-01-23,2023-03-01,0,37
99999.0,374025,30,30,2,2,2023-01-23,2023-02-24,0,32
99999.0,374025,1,1,1,1,2023-01-27,2023-02-24,0,28
99999.0,374025,3,3,1,1,2023-01-27,2023-01-30,0,3
99999.0,374025,3,3,1,1,2023-01-27,2023-02-01,0,5
99999.0,374025,3,3,1,1,2023-01-27,2023-03-01,0,33
99999.0,374025,30,30,1,1,2023-01-27,2023-02-24,0,28
99999.0,374025,30,30,15,15,2023-01-18,2023-02-24,0,37
99999.0,374025,1,1,1,1,2023-01-26,2023-02-24,0,29
99999.0,374025,3,3,1,1,2023-01-26,2023-01-30,0,4
99999.0,374025,3,3,1,1,2023-01-26,2023-02-01,0,6
99999.0,374025,1,1,1,1,2023-01-26,2023-01-27,0,1
99999.0,374025,3,3,1,1,2023-01-26,2023-03-01,0,34
99999.0,374025,30,30,1,1,2023-01-26,2023-02-24,0,29
99999.0,374025,3,3,3,3,2023-01-10,2023-01-30,0,20
99999.0,374025,3,3,3,3,2023-01-10,2023-02-01,0,22
99999.0,374025,3,3,3,3,2023-01-10,2023-03-01,0,50
99999.0,374025,15,15,3,3,2023-01-10,2023-01-18,0,8
99999.0,374025,30,30,3,3,2023-01-10,2023-02-24,0,45
99999.0,374025,15,15,4,4,2023-01-04,2023-01-18,0,14
99999.0,374025,30,30,4,4,2023-01-04,2023-02-24,0,51
99999.0,378019,9,9,5,5,2022-12-30,2023-02-01,0,33
99999.0,378019,50,50,5,5,2022-12-30,2023-01-18,0,19
99999.0,378019,8,8,5,5,2022-12-30,2023-01-26,0,27
99999.0,378019,20,20,5,5,2022-12-30,2023-01-04,0,5
99999.0,378019,50,50,5,5,2022-12-30,2023-02-24,0,56
99999.0,378019,5,5,1,1,2022-12-28,2022-12-30,0,2
99999.0,378019,3,3,1,1,2022-12-28,2023-02-24,0,58
99999.0,378019,1,1,1,1,2022-12-28,2023-01-05,0,8
99999.0,378019,9,9,1,1,2022-12-28,2023-02-01,0,35
99999.0,378019,1,1,1,1,2022-12-28,2023-01-27,0,30
99999.0,378019,50,50,1,1,2022-12-28,2023-01-18,0,21
99999.0,378019,1,1,1,1,2022-12-28,2023-01-26,0,29
99999.0,378019,8,8,1,1,2022-12-28,2023-01-26,0,29
99999.0,378019,20,20,1,1,2022-12-28,2023-01-04,0,7
99999.0,378019,50,50,1,1,2022-12-28,2023-02-24,0,58
99999.0,378019,3,3,3,3,2023-02-24,2023-03-27,0,31
99999.0,378019,14,14,3,3,2023-02-24,2023-03-01,0,5
99999.0,378019,24,24,3,3,2023-02-24,2023-03-01,0,5
99999.0,378019,3,3,1,1,2023-01-05,2023-02-24,0,50
99999.0,378019,9,9,1,1,2023-01-05,2023-02-01,0,27
99999.0,378019,1,1,1,1,2023-01-05,2023-01-27,0,22
99999.0,378019,14,14,1,1,2023-01-05,2023-03-01,0,55
99999.0,378019,24,24,1,1,2023-01-05,2023-03-01,0,55
99999.0,378019,1,1,1,1,2023-01-05,2023-02-27,0,53
99999.0,378019,50,50,1,1,2023-01-05,2023-01-18,0,13
99999.0,378019,1,1,1,1,2023-01-05,2023-01-26,0,21
99999.0,378019,8,8,1,1,2023-01-05,2023-01-26,0,21
99999.0,378019,50,50,1,1,2023-01-05,2023-02-24,0,50
99999.0,378019,14,14,9,9,2023-02-01,2023-03-01,0,28
99999.0,378019,24,24,9,9,2023-02-01,2023-03-01,0,28
99999.0,378019,50,50,9,9,2023-02-01,2023-02-24,0,23
99999.0,378019,3,3,1,1,2023-01-27,2023-03-27,0,59
99999.0,378019,3,3,1,1,2023-01-27,2023-02-24,0,28
99999.0,378019,9,9,1,1,2023-01-27,2023-02-01,0,5
99999.0,378019,14,14,1,1,2023-01-27,2023-03-01,0,33
99999.0,378019,24,24,1,1,2023-01-27,2023-03-01,0,33
99999.0,378019,1,1,1,1,2023-01-27,2023-02-27,0,31
99999.0,378019,50,50,1,1,2023-01-27,2023-02-24,0,28
99999.0,378019,3,3,1,1,2023-02-27,2023-03-27,0,28
99999.0,378019,14,14,1,1,2023-02-27,2023-03-01,0,2
99999.0,378019,24,24,1,1,2023-02-27,2023-03-01,0,2
99999.0,378019,50,50,50,50,2023-01-18,2023-02-24,0,37
99999.0,378019,3,3,1,1,2023-01-26,2023-03-27,0,60
99999.0,378019,3,3,1,1,2023-01-26,2023-02-24,0,29
99999.0,378019,9,9,1,1,2023-01-26,2023-02-01,0,6
99999.0,378019,1,1,1,1,2023-01-26,2023-01-27,0,1
99999.0,378019,14,14,1,1,2023-01-26,2023-03-01,0,34
99999.0,378019,24,24,1,1,2023-01-26,2023-03-01,0,34
99999.0,378019,1,1,1,1,2023-01-26,2023-02-27,0,32
99999.0,378019,50,50,1,1,2023-01-26,2023-02-24,0,29
99999.0,378019,9,9,8,8,2023-01-26,2023-02-01,0,6
99999.0,378019,14,14,8,8,2023-01-26,2023-03-01,0,34
99999.0,378019,24,24,8,8,2023-01-26,2023-03-01,0,34
99999.0,378019,50,50,8,8,2023-01-26,2023-02-24,0,29
99999.0,378019,24,24,20,20,2023-01-04,2023-03-01,0,56
99999.0,378019,50,50,20,20,2023-01-04,2023-01-18,0,14
99999.0,378019,50,50,20,20,2023-01-04,2023-02-24,0,51
99999.0,387036,2,2,2,2,2023-01-18,2023-02-10,0,23
99999.0,388018,10,10,10,10,2023-01-18,2023-02-24,0,37
99999.0,390021,20,20,12,12,2022-11-09,2022-12-14,0,35
99999.0,504010,2,2,1,1,2021-09-08,2021-10-12,0,34
99999.0,505018,4,4,2,2,2021-09-08,2021-10-12,0,34
99999.0,931999,2,2,2,2,2022-12-16,2023-01-18,0,33
99999.0,931999,6,6,2,2,2022-12-16,2023-02-01,0,47
99999.0,931999,4,4,2,2,2022-12-16,2023-02-01,0,47
99999.0,931999,2,2,1,1,2022-12-09,2022-12-16,0,7
99999.0,931999,1,0,1,1,2022-12-09,2022-12-25,0,16
99999.0,931999,1,0,1,1,2022-12-09,2023-01-26,0,48
99999.0,931999,2,2,1,1,2022-12-09,2023-01-18,0,40
99999.0,931999,1,0,1,1,2022-12-09,2023-02-07,0,60
99999.0,931999,1,1,1,1,2022-12-09,2023-02-01,0,54
99999.0,931999,6,6,1,1,2022-12-09,2023-02-01,0,54
99999.0,931999,4,4,1,1,2022-12-09,2023-02-01,0,54
99999.0,931999,1,1,1,1,2022-12-09,2023-02-01,0,54
99999.0,931999,1,0,1,0,2022-12-25,2023-01-26,1,32
99999.0,931999,2,2,1,0,2022-12-25,2023-01-18,1,24
99999.0,931999,1,0,1,0,2022-12-25,2023-02-07,1,44
99999.0,931999,1,0,1,0,2022-12-25,2023-02-10,1,47
99999.0,931999,1,1,1,0,2022-12-25,2023-02-01,1,38
99999.0,931999,6,6,1,0,2022-12-25,2023-02-01,1,38
99999.0,931999,4,4,1,0,2022-12-25,2023-02-01,1,38
99999.0,931999,1,1,1,0,2022-12-25,2023-02-01,1,38
99999.0,931999,1,0,1,0,2023-03-15,2023-03-28,1,13
99999.0,931999,1,0,1,0,2023-01-26,2023-03-15,1,48
99999.0,931999,1,0,1,0,2023-01-26,2023-02-07,1,12
99999.0,931999,1,0,1,0,2023-01-26,2023-02-10,1,15
99999.0,931999,1,1,1,0,2023-01-26,2023-02-01,1,6
99999.0,931999,6,6,1,0,2023-01-26,2023-02-01,1,6
99999.0,931999,4,4,1,0,2023-01-26,2023-02-01,1,6
99999.0,931999,1,1,1,0,2023-01-26,2023-02-01,1,6
99999.0,931999,6,6,2,2,2023-01-18,2023-02-01,0,14
99999.0,931999,4,4,2,2,2023-01-18,2023-02-01,0,14
99999.0,931999,1,0,1,0,2023-02-07,2023-03-28,1,49
99999.0,931999,1,0,1,0,2023-02-07,2023-03-15,1,36
99999.0,931999,1,0,1,0,2023-02-07,2023-02-10,1,3
99999.0,931999,1,0,1,0,2023-02-10,2023-03-28,1,46
99999.0,931999,1,0,1,0,2023-02-10,2023-03-15,1,33
99999.0,931999,1,0,1,1,2023-02-01,2023-03-28,0,55
99999.0,931999,1,0,1,1,2023-02-01,2023-03-15,0,42
99999.0,931999,1,0,1,1,2023-02-01,2023-02-07,0,6
99999.0,931999,1,0,1,1,2023-02-01,2023-02-10,0,9
99999.0,931999,1,0,1,1,2023-02-01,2023-03-28,0,55
99999.0,931999,1,0,1,1,2023-02-01,2023-03-15,0,42
99999.0,931999,1,0,1,1,2023-02-01,2023-02-07,0,6
99999.0,931999,1,0,1,1,2023-02-01,2023-02-10,0,9
99999.0,1105403,24,24,5,5,2023-01-03,2023-02-08,0,36
99999.0,1105403,24,24,4,4,2023-01-26,2023-02-08,0,13
99999.0,1402403,6,6,6,6,2023-01-30,2023-02-13,0,14
99999.0,1431402,2,2,2,2,2023-02-01,2023-02-02,0,1
99999.0,1660407,10,10,10,10,2023-01-06,2023-02-27,0,52
99999.0,1676404,4,0,4,0,2023-01-31,2023-03-02,4,30
99999.0,3029395,4,4,1,1,2023-01-27,2023-03-28,0,60
99999.0,4064408,12,12,16,0,2022-09-28,2022-11-23,16,56
99999.0,4064408,24,24,8,8,2022-12-25,2023-02-08,0,45
99999.0,4064408,16,16,12,12,2022-11-23,2022-11-29,0,6
99999.0,4064408,24,24,1,1,2023-02-02,2023-02-08,0,6
99999.0,4139409,128,128,64,64,2022-09-21,2022-09-28,0,7
99999.0,4520400,48,48,64,0,2022-09-28,2022-11-23,64,56
99999.0,4520400,64,64,48,48,2022-11-23,2022-11-29,0,6
99999.0,4520400,64,0,64,64,2022-09-15,2022-09-28,0,13
99999.0,4520400,2,2,2,2,2023-03-14,2023-03-27,0,13
99999.0,4520400,39,39,2,2,2023-01-17,2023-02-21,0,35
99999.0,4520400,2,2,2,2,2023-01-17,2023-03-14,0,56
99999.0,4520400,2,2,2,2,2023-01-17,2023-03-07,0,49
99999.0,4520400,4,4,2,2,2023-01-17,2023-01-26,0,9
99999.0,4520400,39,39,3,3,2023-01-05,2023-02-21,0,47
99999.0,4520400,4,4,3,3,2023-01-05,2023-01-26,0,21
99999.0,4520400,2,2,2,2,2023-03-07,2023-03-27,0,20
99999.0,4520400,2,2,2,2,2023-03-07,2023-03-14,0,7
99999.0,4520400,39,39,4,4,2023-01-26,2023-02-21,0,26
99999.0,4757409,153,153,2,0,2023-01-31,2023-02-21,2,21
99999.0,4907400,9,9,2,2,2023-01-30,2023-02-02,0,3
99999.0,4907400,9,9,2,2,2023-01-30,2023-02-01,0,2
99999.0,4907400,64,64,2,2,2023-01-30,2023-02-08,0,9
99999.0,4907400,2,2,25,0,2023-01-17,2023-01-30,25,13
99999.0,4907400,9,9,25,0,2023-01-17,2023-02-02,25,16
99999.0,4907400,9,9,25,0,2023-01-17,2023-02-01,25,15
99999.0,4907400,64,64,25,0,2023-01-17,2023-02-08,25,22
99999.0,4907400,64,64,9,9,2023-02-02,2023-02-08,0,6
99999.0,4907400,9,9,9,9,2023-02-01,2023-02-02,0,1
99999.0,4907400,64,64,9,9,2023-02-01,2023-02-08,0,7
99999.0,5148409,64,64,4,4,2022-12-25,2023-02-07,0,44
99999.0,5148409,40,40,4,4,2022-12-25,2023-01-10,0,16
99999.0,5148409,64,64,40,40,2023-01-10,2023-02-07,0,28
99999.0,5148409,40,40,40,40,2023-01-10,2023-02-27,0,48
99999.0,5307401,8,0,1,1,2023-01-20,2023-01-31,0,11
99999.0,5307401,2,0,1,1,2023-01-20,2023-02-23,0,34
99999.0,5307401,1,1,1,1,2023-01-20,2023-02-23,0,34
99999.0,5307401,2,2,1,1,2023-01-20,2023-02-27,0,38
99999.0,5307401,2,0,8,0,2023-01-31,2023-02-23,8,23
99999.0,5307401,1,1,8,0,2023-01-31,2023-02-23,8,23
99999.0,5307401,2,2,8,0,2023-01-31,2023-02-27,8,27
99999.0,5307401,2,2,2,0,2023-02-23,2023-02-27,2,4
99999.0,5307401,2,2,1,1,2023-02-23,2023-02-27,0,4
99999.0,5480405,4,4,3,3,2023-01-05,2023-01-10,0,5
99999.0,5480405,3,3,3,3,2023-01-05,2023-02-13,0,39
99999.0,5482401,80,80,1,1,2022-12-12,2022-12-25,0,13
99999.0,5482401,64,64,1,1,2022-12-12,2023-02-01,0,51
99999.0,5482401,32,32,1,1,2022-12-12,2023-02-08,0,58
99999.0,5482401,2,2,1,1,2022-12-12,2023-01-17,0,36
99999.0,5482401,60,60,1,1,2022-12-12,2023-02-09,0,59
99999.0,5482401,8,8,1,1,2022-12-12,2023-01-26,0,45
99999.0,5482401,24,24,1,1,2022-12-12,2023-01-03,0,22
99999.0,5482401,1,1,1,1,2022-12-12,2023-01-20,0,39
99999.0,5482401,6,6,1,1,2022-12-12,2023-01-20,0,39
99999.0,5482401,32,32,32,32,2023-02-21,2023-03-08,0,15
99999.0,5482401,32,32,32,32,2023-02-08,2023-02-21,0,13
99999.0,5482401,60,60,32,32,2023-02-08,2023-02-09,0,1
99999.0,5482401,32,32,32,32,2023-02-08,2023-03-08,0,28
99999.0,5482401,6,6,2,2,2023-03-21,2023-03-27,0,6
99999.0,5482401,64,64,2,2,2023-01-17,2023-02-01,0,15
99999.0,5482401,32,32,2,2,2023-01-17,2023-02-21,0,35
99999.0,5482401,32,32,2,2,2023-01-17,2023-02-08,0,22
99999.0,5482401,60,60,2,2,2023-01-17,2023-02-09,0,23
99999.0,5482401,4,4,2,2,2023-01-17,2023-02-17,0,31
99999.0,5482401,8,8,2,2,2023-01-17,2023-01-26,0,9
99999.0,5482401,32,32,2,2,2023-01-17,2023-03-08,0,50
99999.0,5482401,24,24,2,2,2023-01-17,2023-02-17,0,31
99999.0,5482401,24,24,2,2,2023-01-17,2023-03-15,0,57
99999.0,5482401,3,3,2,2,2023-01-17,2023-02-13,0,27
99999.0,5482401,6,6,2,2,2023-01-17,2023-01-20,0,3
99999.0,5482401,4,4,2,2,2023-01-17,2023-03-06,0,48
99999.0,5482401,7,7,2,2,2023-01-17,2023-02-24,0,38
99999.0,5482401,6,6,4,4,2023-02-17,2023-03-27,0,38
99999.0,5482401,32,32,4,4,2023-02-17,2023-02-21,0,4
99999.0,5482401,32,32,4,4,2023-02-17,2023-03-08,0,19
99999.0,5482401,24,24,4,4,2023-02-17,2023-03-15,0,26
99999.0,5482401,4,4,4,4,2023-02-17,2023-03-06,0,17
99999.0,5482401,7,7,4,4,2023-02-17,2023-02-24,0,7
99999.0,5482401,64,64,8,8,2023-01-26,2023-02-01,0,6
99999.0,5482401,32,32,8,8,2023-01-26,2023-02-21,0,26
99999.0,5482401,32,32,8,8,2023-01-26,2023-02-08,0,13
99999.0,5482401,60,60,8,8,2023-01-26,2023-02-09,0,14
99999.0,5482401,32,32,8,8,2023-01-26,2023-03-08,0,41
99999.0,5482401,24,24,8,8,2023-01-26,2023-02-17,0,22
99999.0,5482401,24,24,8,8,2023-01-26,2023-03-15,0,48
99999.0,5482401,64,64,24,24,2023-01-03,2023-02-01,0,29
99999.0,5482401,32,32,24,24,2023-01-03,2023-02-21,0,49
99999.0,5482401,32,32,24,24,2023-01-03,2023-02-08,0,36
99999.0,5482401,60,60,24,24,2023-01-03,2023-02-09,0,37
99999.0,5482401,24,24,24,24,2023-01-03,2023-02-17,0,45
99999.0,5482401,64,64,1,1,2023-01-20,2023-02-01,0,12
99999.0,5482401,32,32,1,1,2023-01-20,2023-02-21,0,32
99999.0,5482401,32,32,1,1,2023-01-20,2023-02-08,0,19
99999.0,5482401,2,2,1,1,2023-01-20,2023-03-21,0,60
99999.0,5482401,60,60,1,1,2023-01-20,2023-02-09,0,20
99999.0,5482401,4,4,1,1,2023-01-20,2023-02-17,0,28
99999.0,5482401,8,8,1,1,2023-01-20,2023-01-26,0,6
99999.0,5482401,32,32,1,1,2023-01-20,2023-03-08,0,47
99999.0,5482401,24,24,1,1,2023-01-20,2023-02-17,0,28
99999.0,5482401,24,24,1,1,2023-01-20,2023-03-15,0,54
99999.0,5482401,3,3,1,1,2023-01-20,2023-02-13,0,24
99999.0,5482401,4,4,1,1,2023-01-20,2023-03-06,0,45
99999.0,5482401,7,7,1,1,2023-01-20,2023-02-24,0,35
99999.0,5482401,32,32,24,24,2023-02-17,2023-02-21,0,4
99999.0,5482401,32,32,24,24,2023-02-17,2023-03-08,0,19
99999.0,5482401,24,24,24,24,2023-02-17,2023-03-15,0,26
99999.0,5482401,6,6,3,3,2023-02-13,2023-03-27,0,42
99999.0,5482401,32,32,3,3,2023-02-13,2023-02-21,0,8
99999.0,5482401,4,4,3,3,2023-02-13,2023-02-17,0,4
99999.0,5482401,32,32,3,3,2023-02-13,2023-03-08,0,23
99999.0,5482401,24,24,3,3,2023-02-13,2023-02-17,0,4
99999.0,5482401,24,24,3,3,2023-02-13,2023-03-15,0,30
99999.0,5482401,4,4,3,3,2023-02-13,2023-03-06,0,21
99999.0,5482401,7,7,3,3,2023-02-13,2023-02-24,0,11
99999.0,5482401,64,64,6,6,2023-01-20,2023-02-01,0,12
99999.0,5482401,32,32,6,6,2023-01-20,2023-02-21,0,32
99999.0,5482401,32,32,6,6,2023-01-20,2023-02-08,0,19
99999.0,5482401,60,60,6,6,2023-01-20,2023-02-09,0,20
99999.0,5482401,8,8,6,6,2023-01-20,2023-01-26,0,6
99999.0,5482401,32,32,6,6,2023-01-20,2023-03-08,0,47
99999.0,5482401,24,24,6,6,2023-01-20,2023-02-17,0,28
99999.0,5482401,24,24,6,6,2023-01-20,2023-03-15,0,54
99999.0,5482401,7,7,6,6,2023-01-20,2023-02-24,0,35
99999.0,5482401,6,6,4,4,2023-03-06,2023-03-27,0,21
99999.0,5482401,32,32,4,4,2023-03-06,2023-03-08,0,2
99999.0,5482401,24,24,4,4,2023-03-06,2023-03-15,0,9
99999.0,5482401,32,32,7,7,2023-02-24,2023-03-08,0,12
99999.0,5482401,24,24,7,7,2023-02-24,2023-03-15,0,19
99999.0,5483409,36,36,32,0,2022-09-28,2022-11-23,32,56
99999.0,5483409,32,32,2,2,2022-12-25,2023-02-21,0,58
99999.0,5483409,2,2,2,2,2022-12-25,2023-02-13,0,50
99999.0,5483409,32,32,1,1,2023-01-23,2023-02-21,0,29
99999.0,5483409,2,2,1,1,2023-01-23,2023-02-13,0,21
99999.0,5483409,1,1,1,1,2023-01-23,2023-01-26,0,3
99999.0,5483409,32,32,2,2,2023-02-13,2023-02-21,0,8
99999.0,5483409,32,32,1,1,2023-01-26,2023-02-21,0,26
99999.0,5483409,2,2,1,1,2023-01-26,2023-02-13,0,18
99999.0,5985405,4,4,1,1,2023-03-15,2023-03-28,0,13
99999.0,6598405,48,48,32,0,2022-09-28,2022-10-11,32,13
99999.0,6598405,32,32,32,0,2022-09-28,2022-11-23,32,56
99999.0,6598405,48,48,128,0,2022-09-28,2022-10-11,128,13
99999.0,6598405,32,32,128,0,2022-09-28,2022-11-23,128,56
99999.0,6598405,64,64,32,32,2023-02-07,2023-02-08,0,1
99999.0,6598405,96,96,8,8,2023-01-11,2023-02-01,0,21
99999.0,6598405,32,32,8,8,2023-01-11,2023-02-07,0,27
99999.0,6598405,20,20,8,8,2023-01-11,2023-02-06,0,26
99999.0,6598405,64,64,8,8,2023-01-11,2023-02-08,0,28
99999.0,6598405,96,96,4,4,2023-01-18,2023-02-01,0,14
99999.0,6598405,32,32,4,4,2023-01-18,2023-02-07,0,20
99999.0,6598405,20,20,4,4,2023-01-18,2023-02-06,0,19
99999.0,6598405,64,64,4,4,2023-01-18,2023-02-08,0,21
99999.0,6598405,2,2,2,2,2023-03-07,2023-03-27,0,20
99999.0,6598405,3,3,2,2,2023-03-07,2023-03-13,0,6
99999.0,6598405,10,10,2,2,2023-03-07,2023-03-22,0,15
99999.0,6598405,32,32,20,20,2023-02-06,2023-02-07,0,1
99999.0,6598405,64,64,20,20,2023-02-06,2023-02-08,0,2
99999.0,6598405,10,10,3,3,2023-03-13,2023-03-22,0,9
99999.0,6623400,6,6,6,6,2022-12-25,2023-01-11,0,17
99999.0,6675401,36,0,20,20,2022-12-06,2023-01-24,0,49
99999.0,6675401,36,36,20,20,2022-12-06,2023-01-24,0,49
99999.0,6675401,640,640,224,224,2022-09-15,2022-09-21,0,6
99999.0,6675401,39,39,12,12,2023-02-27,2023-03-10,0,11
99999.0,6675401,25,25,12,12,2023-02-27,2023-03-15,0,16
99999.0,6675401,12,12,8,8,2023-02-13,2023-02-27,0,14
99999.0,6675401,11,11,8,8,2023-02-13,2023-03-10,0,25
99999.0,6675401,39,39,8,8,2023-02-13,2023-03-10,0,25
99999.0,6675401,25,25,8,8,2023-02-13,2023-03-15,0,30
99999.0,6675401,12,12,36,0,2023-01-24,2023-02-27,36,34
99999.0,6675401,8,8,36,0,2023-01-24,2023-02-13,36,20
99999.0,6675401,6,6,36,0,2023-01-24,2023-02-21,36,28
99999.0,6675401,11,11,36,0,2023-01-24,2023-03-10,36,45
99999.0,6675401,39,39,36,0,2023-01-24,2023-03-10,36,45
99999.0,6675401,25,25,36,0,2023-01-24,2023-03-15,36,50
99999.0,6675401,5,5,36,0,2023-01-24,2023-03-08,36,43
99999.0,6675401,5,5,36,0,2023-01-24,2023-03-08,36,43
99999.0,6675401,39,39,36,36,2023-01-24,2023-03-10,0,45
99999.0,6675401,12,12,6,6,2023-02-21,2023-02-27,0,6
99999.0,6675401,11,11,6,6,2023-02-21,2023-03-10,0,17
99999.0,6675401,39,39,6,6,2023-02-21,2023-03-10,0,17
99999.0,6675401,25,25,6,6,2023-02-21,2023-03-15,0,22
99999.0,6675401,25,25,11,11,2023-03-10,2023-03-15,0,5
99999.0,6675401,11,11,5,5,2023-03-08,2023-03-10,0,2
99999.0,6675401,39,39,5,5,2023-03-08,2023-03-10,0,2
99999.0,6675401,25,25,5,5,2023-03-08,2023-03-15,0,7
99999.0,6675401,11,11,5,5,2023-03-08,2023-03-10,0,2
99999.0,6675401,39,39,5,5,2023-03-08,2023-03-10,0,2
99999.0,6675401,25,25,5,5,2023-03-08,2023-03-15,0,7
99999.0,6923016,15,15,8,8,2023-01-09,2023-01-18,0,9
99999.0,6968020,10,10,1,1,2023-01-17,2023-01-18,0,1
99999.0,6968020,15,15,1,1,2023-01-17,2023-02-24,0,38
99999.0,6968020,15,15,10,10,2023-01-18,2023-02-24,0,37
99999.0,6968020,10,10,3,3,2023-01-04,2023-01-18,0,14
99999.0,6968020,15,15,3,3,2023-01-04,2023-02-24,0,51
99999.0,6968038,10,10,2,2,2023-01-04,2023-01-18,0,14
99999.0,6979407,10,0,2,2,2022-12-16,2023-02-07,0,53
99999.0,6979407,8,0,2,2,2022-12-16,2023-01-30,0,45
99999.0,6979407,2,2,2,2,2022-12-16,2023-01-27,0,42
99999.0,6979407,20,20,2,2,2022-12-16,2023-01-13,0,28
99999.0,6979407,8,8,2,2,2022-12-16,2023-01-05,0,20
99999.0,6979407,6,6,2,2,2022-12-16,2023-01-09,0,24
99999.0,6979407,12,12,2,2,2022-12-16,2023-01-17,0,32
99999.0,6979407,2,0,2,2,2022-12-16,2023-01-31,0,46
99999.0,6979407,3,3,2,2,2022-12-16,2023-01-20,0,35
99999.0,6979407,8,8,2,2,2022-12-16,2023-02-13,0,59
99999.0,6979407,2,2,2,2,2022-12-09,2022-12-16,0,7
99999.0,6979407,10,0,2,2,2022-12-09,2023-02-07,0,60
99999.0,6979407,8,0,2,2,2022-12-09,2023-01-30,0,52
99999.0,6979407,2,2,2,2,2022-12-09,2023-01-27,0,49
99999.0,6979407,20,20,2,2,2022-12-09,2023-01-13,0,35
99999.0,6979407,8,8,2,2,2022-12-09,2023-01-05,0,27
99999.0,6979407,6,6,2,2,2022-12-09,2023-01-09,0,31
99999.0,6979407,12,12,2,2,2022-12-09,2023-01-17,0,39
99999.0,6979407,2,0,2,2,2022-12-09,2023-01-31,0,53
99999.0,6979407,3,3,2,2,2022-12-09,2023-01-20,0,42
99999.0,6979407,2,2,128,0,2022-11-23,2022-12-16,128,23
99999.0,6979407,2,2,128,0,2022-11-23,2022-12-09,128,16
99999.0,6979407,1,1,128,0,2022-11-23,2023-01-18,128,56
99999.0,6979407,1,1,128,0,2022-11-23,2023-01-17,128,55
99999.0,6979407,20,20,128,0,2022-11-23,2023-01-13,128,51
99999.0,6979407,8,8,128,0,2022-11-23,2023-01-05,128,43
99999.0,6979407,6,6,128,0,2022-11-23,2023-01-09,128,47
99999.0,6979407,12,12,128,0,2022-11-23,2023-01-17,128,55
99999.0,6979407,3,3,128,0,2022-11-23,2023-01-20,128,58
99999.0,6979407,5,5,10,0,2023-02-07,2023-02-27,10,20
99999.0,6979407,4,4,10,0,2023-02-07,2023-03-08,10,29
99999.0,6979407,4,0,10,0,2023-02-07,2023-03-07,10,28
99999.0,6979407,8,8,10,0,2023-02-07,2023-02-13,10,6
99999.0,6979407,4,0,10,0,2023-02-07,2023-03-07,10,28
99999.0,6979407,5,5,1,1,2023-01-18,2023-02-27,0,40
99999.0,6979407,10,0,1,1,2023-01-18,2023-02-07,0,20
99999.0,6979407,4,4,1,1,2023-01-18,2023-03-08,0,49
99999.0,6979407,8,0,1,1,2023-01-18,2023-01-30,0,12
99999.0,6979407,2,2,1,1,2023-01-18,2023-01-27,0,9
99999.0,6979407,4,0,1,1,2023-01-18,2023-03-07,0,48
99999.0,6979407,2,0,1,1,2023-01-18,2023-01-31,0,13
99999.0,6979407,3,3,1,1,2023-01-18,2023-01-20,0,2
99999.0,6979407,8,8,1,1,2023-01-18,2023-02-13,0,26
99999.0,6979407,4,0,1,1,2023-01-18,2023-03-07,0,48
99999.0,6979407,5,5,8,0,2023-01-30,2023-02-27,8,28
99999.0,6979407,10,0,8,0,2023-01-30,2023-02-07,8,8
99999.0,6979407,4,4,8,0,2023-01-30,2023-03-08,8,37
99999.0,6979407,4,0,8,0,2023-01-30,2023-03-07,8,36
99999.0,6979407,2,0,8,0,2023-01-30,2023-01-31,8,1
99999.0,6979407,8,8,8,0,2023-01-30,2023-02-13,8,14
99999.0,6979407,4,0,8,0,2023-01-30,2023-03-07,8,36
99999.0,6979407,5,5,1,1,2023-01-17,2023-02-27,0,41
99999.0,6979407,10,0,1,1,2023-01-17,2023-02-07,0,21
99999.0,6979407,1,1,1,1,2023-01-17,2023-01-18,0,1
99999.0,6979407,4,4,1,1,2023-01-17,2023-03-08,0,50
99999.0,6979407,8,0,1,1,2023-01-17,2023-01-30,0,13
99999.0,6979407,2,2,1,1,2023-01-17,2023-01-27,0,10
99999.0,6979407,4,0,1,1,2023-01-17,2023-03-07,0,49
99999.0,6979407,2,0,1,1,2023-01-17,2023-01-31,0,14
99999.0,6979407,3,3,1,1,2023-01-17,2023-01-20,0,3
99999.0,6979407,8,8,1,1,2023-01-17,2023-02-13,0,27
99999.0,6979407,4,0,1,1,2023-01-17,2023-03-07,0,49
99999.0,6979407,5,5,2,2,2023-01-27,2023-02-27,0,31
99999.0,6979407,10,0,2,2,2023-01-27,2023-02-07,0,11
99999.0,6979407,4,4,2,2,2023-01-27,2023-03-08,0,40
99999.0,6979407,8,0,2,2,2023-01-27,2023-01-30,0,3
99999.0,6979407,4,0,2,2,2023-01-27,2023-03-07,0,39
99999.0,6979407,2,0,2,2,2023-01-27,2023-01-31,0,4
99999.0,6979407,8,8,2,2,2023-01-27,2023-02-13,0,17
99999.0,6979407,4,0,2,2,2023-01-27,2023-03-07,0,39
99999.0,6979407,10,0,8,8,2023-01-05,2023-02-07,0,33
99999.0,6979407,8,0,8,8,2023-01-05,2023-01-30,0,25
99999.0,6979407,20,20,8,8,2023-01-05,2023-01-13,0,8
99999.0,6979407,12,12,8,8,2023-01-05,2023-01-17,0,12
99999.0,6979407,8,8,8,8,2023-01-05,2023-02-13,0,39
99999.0,6979407,4,4,4,0,2023-03-07,2023-03-08,4,1
99999.0,6979407,10,0,6,6,2023-01-09,2023-02-07,0,29
99999.0,6979407,8,0,6,6,2023-01-09,2023-01-30,0,21
99999.0,6979407,20,20,6,6,2023-01-09,2023-01-13,0,4
99999.0,6979407,12,12,6,6,2023-01-09,2023-01-17,0,8
99999.0,6979407,8,8,6,6,2023-01-09,2023-02-13,0,35
99999.0,6979407,5,5,2,0,2023-01-31,2023-02-27,2,27
99999.0,6979407,10,0,2,0,2023-01-31,2023-02-07,2,7
99999.0,6979407,4,4,2,0,2023-01-31,2023-03-08,2,36
99999.0,6979407,4,0,2,0,2023-01-31,2023-03-07,2,35
99999.0,6979407,8,8,2,0,2023-01-31,2023-02-13,2,13
99999.0,6979407,4,0,2,0,2023-01-31,2023-03-07,2,35
99999.0,6979407,5,5,3,3,2023-01-20,2023-02-27,0,38
99999.0,6979407,10,0,3,3,2023-01-20,2023-02-07,0,18
99999.0,6979407,4,4,3,3,2023-01-20,2023-03-08,0,47
99999.0,6979407,8,0,3,3,2023-01-20,2023-01-30,0,10
99999.0,6979407,4,0,3,3,2023-01-20,2023-03-07,0,46
99999.0,6979407,8,8,3,3,2023-01-20,2023-02-13,0,24
99999.0,6979407,4,0,3,3,2023-01-20,2023-03-07,0,46
99999.0,6979407,4,4,4,0,2023-03-07,2023-03-08,4,1
99999.0,6981402,4,4,10,0,2023-02-07,2023-03-07,10,28
99999.0,8110744,1,1,1,1,2022-11-29,2023-01-10,0,42
99999.0,8162018,3,3,2,2,2023-01-03,2023-01-10,0,7
99999.0,8167018,24,24,12,12,2022-12-15,2023-01-12,0,28
99999.0,8167018,15,15,12,12,2022-12-15,2023-02-13,0,60
99999.0,8167018,12,12,12,12,2022-12-15,2023-02-09,0,56
99999.0,8167018,12,12,4,4,2022-12-08,2022-12-15,0,7
99999.0,8167018,24,24,4,4,2022-12-08,2023-01-12,0,35
99999.0,8167018,10,10,4,4,2022-12-08,2023-01-18,0,41
99999.0,8167018,6,6,4,4,2022-12-08,2023-01-19,0,42
99999.0,8167018,12,12,10,10,2022-11-23,2022-12-15,0,22
99999.0,8167018,24,24,10,10,2022-11-23,2023-01-12,0,50
99999.0,8167018,10,10,10,10,2022-11-23,2023-01-18,0,56
99999.0,8167018,26,26,24,24,2023-01-12,2023-02-15,0,34
99999.0,8167018,12,12,10,10,2023-01-18,2023-03-14,0,55
99999.0,8167018,15,15,10,10,2023-01-18,2023-02-13,0,26
99999.0,8167018,26,26,10,10,2023-01-18,2023-02-15,0,28
99999.0,8167018,12,12,10,10,2023-01-18,2023-02-09,0,22
99999.0,8167018,24,24,3,3,2023-01-04,2023-01-12,0,8
99999.0,8167018,10,10,3,3,2023-01-04,2023-01-18,0,14
99999.0,8167018,6,6,3,3,2023-01-04,2023-01-19,0,15
99999.0,8167018,8,8,3,3,2023-01-04,2023-02-17,0,44
99999.0,8167018,15,15,3,3,2023-01-04,2023-02-13,0,40
99999.0,8167018,26,26,3,3,2023-01-04,2023-02-15,0,42
99999.0,8167018,4,4,3,3,2023-01-04,2023-03-01,0,56
99999.0,8167018,3,3,3,3,2023-01-04,2023-02-27,0,54
99999.0,8167018,12,12,3,3,2023-01-04,2023-02-09,0,36
99999.0,8167018,8,8,3,3,2023-01-04,2023-02-10,0,37
99999.0,8167018,12,12,6,6,2023-01-19,2023-03-14,0,54
99999.0,8167018,8,8,6,6,2023-01-19,2023-02-17,0,29
99999.0,8167018,15,15,6,6,2023-01-19,2023-02-13,0,25
99999.0,8167018,26,26,6,6,2023-01-19,2023-02-15,0,27
99999.0,8167018,12,12,6,6,2023-01-19,2023-02-09,0,21
99999.0,8167018,8,8,6,6,2023-01-19,2023-02-10,0,22
99999.0,8167018,12,12,8,8,2023-02-17,2023-03-14,0,25
99999.0,8167018,12,12,2,2,2023-01-16,2023-03-14,0,57
99999.0,8167018,10,10,2,2,2023-01-16,2023-01-18,0,2
99999.0,8167018,6,6,2,2,2023-01-16,2023-01-19,0,3
99999.0,8167018,8,8,2,2,2023-01-16,2023-02-17,0,32
99999.0,8167018,15,15,2,2,2023-01-16,2023-02-13,0,28
99999.0,8167018,26,26,2,2,2023-01-16,2023-02-15,0,30
99999.0,8167018,4,4,2,2,2023-01-16,2023-03-01,0,44
99999.0,8167018,4,4,2,2,2023-01-16,2023-03-13,0,56
99999.0,8167018,3,3,2,2,2023-01-16,2023-02-27,0,42
99999.0,8167018,12,12,2,2,2023-01-16,2023-02-09,0,24
99999.0,8167018,8,8,2,2,2023-01-16,2023-02-10,0,25
99999.0,8167018,2,2,2,2,2023-01-16,2023-03-13,0,56
99999.0,8167018,2,2,2,2,2023-01-16,2023-02-23,0,38
99999.0,8167018,26,26,15,15,2023-02-13,2023-02-15,0,2
99999.0,8167018,12,12,4,4,2023-03-01,2023-03-14,0,13
99999.0,8167018,4,4,4,4,2023-03-01,2023-03-13,0,12
99999.0,8167018,7,7,4,4,2023-03-01,2023-03-21,0,20
99999.0,8167018,12,12,1,1,2023-02-22,2023-03-14,0,20
99999.0,8167018,3,3,1,1,2023-02-22,2023-03-27,0,33
99999.0,8167018,4,4,1,1,2023-02-22,2023-03-01,0,7
99999.0,8167018,4,4,1,1,2023-02-22,2023-03-13,0,19
99999.0,8167018,3,3,1,1,2023-02-22,2023-02-27,0,5
99999.0,8167018,7,7,1,1,2023-02-22,2023-03-21,0,27
99999.0,8167018,2,2,1,1,2023-02-22,2023-03-13,0,19
99999.0,8167018,2,2,1,1,2023-02-22,2023-02-23,0,1
99999.0,8167018,12,12,4,4,2023-03-13,2023-03-14,0,1
99999.0,8167018,7,7,4,4,2023-03-13,2023-03-21,0,8
99999.0,8167018,12,12,3,3,2023-02-27,2023-03-14,0,15
99999.0,8167018,3,3,3,3,2023-02-27,2023-03-27,0,28
99999.0,8167018,4,4,3,3,2023-02-27,2023-03-01,0,2
99999.0,8167018,4,4,3,3,2023-02-27,2023-03-13,0,14
99999.0,8167018,7,7,3,3,2023-02-27,2023-03-21,0,22
99999.0,8167018,12,12,12,12,2023-02-09,2023-03-14,0,33
99999.0,8167018,15,15,12,12,2023-02-09,2023-02-13,0,4
99999.0,8167018,26,26,12,12,2023-02-09,2023-02-15,0,6
99999.0,8167018,12,12,8,8,2023-02-10,2023-03-14,0,32
99999.0,8167018,8,8,8,8,2023-02-10,2023-02-17,0,7
99999.0,8167018,15,15,8,8,2023-02-10,2023-02-13,0,3
99999.0,8167018,26,26,8,8,2023-02-10,2023-02-15,0,5
99999.0,8167018,12,12,2,2,2023-03-13,2023-03-14,0,1
99999.0,8167018,3,3,2,2,2023-03-13,2023-03-27,0,14
99999.0,8167018,7,7,2,2,2023-03-13,2023-03-21,0,8
99999.0,8167018,12,12,2,2,2023-02-23,2023-03-14,0,19
99999.0,8167018,3,3,2,2,2023-02-23,2023-03-27,0,32
99999.0,8167018,4,4,2,2,2023-02-23,2023-03-01,0,6
99999.0,8167018,4,4,2,2,2023-02-23,2023-03-13,0,18
99999.0,8167018,3,3,2,2,2023-02-23,2023-02-27,0,4
99999.0,8167018,7,7,2,2,2023-02-23,2023-03-21,0,26
99999.0,8167018,2,2,2,2,2023-02-23,2023-03-13,0,18
99999.0,8168016,1,1,1,1,2022-12-13,2023-01-18,0,36
99999.0,8168016,1,1,1,1,2022-12-13,2023-01-26,0,44
99999.0,8168016,1,1,1,1,2023-01-18,2023-01-26,0,8
99999.0,8199011,2,2,2,0,2022-12-15,2023-01-05,2,21
99999.0,8199011,4,4,2,2,2023-02-17,2023-02-23,0,6
99999.0,8199011,2,2,2,2,2023-01-05,2023-02-17,0,43
99999.0,8199011,4,4,2,2,2023-01-05,2023-02-23,0,49
99999.0,8200016,10,10,3,3,2022-12-05,2023-02-03,0,60
99999.0,8200016,8,8,3,3,2022-12-05,2023-01-27,0,53
99999.0,8200016,12,12,10,10,2023-02-03,2023-02-13,0,10
99999.0,8200016,12,0,10,10,2023-02-03,2023-02-10,0,7
99999.0,8200016,10,10,1,1,2023-02-02,2023-02-03,0,1
99999.0,8200016,2,2,1,1,2023-02-02,2023-02-21,0,19
99999.0,8200016,1,1,1,1,2023-02-02,2023-03-27,0,53
99999.0,8200016,1,1,1,1,2023-02-02,2023-02-15,0,13
99999.0,8200016,12,12,1,1,2023-02-02,2023-02-13,0,11
99999.0,8200016,3,3,1,1,2023-02-02,2023-02-10,0,8
99999.0,8200016,4,4,1,1,2023-02-02,2023-02-17,0,15
99999.0,8200016,3,3,1,1,2023-02-02,2023-02-15,0,13
99999.0,8200016,1,1,1,1,2023-02-02,2023-03-07,0,33
99999.0,8200016,3,3,1,1,2023-02-02,2023-02-09,0,7
99999.0,8200016,12,0,1,1,2023-02-02,2023-02-10,0,8
99999.0,8200016,2,2,1,1,2023-02-02,2023-02-28,0,26
99999.0,8200016,2,2,1,1,2023-02-02,2023-03-13,0,39
99999.0,8200016,2,2,1,1,2023-02-02,2023-03-28,0,54
99999.0,8200016,2,2,2,2,2023-02-21,2023-02-28,0,7
99999.0,8200016,2,2,2,2,2023-02-21,2023-03-13,0,20
99999.0,8200016,2,2,2,2,2023-02-21,2023-03-28,0,35
99999.0,8200016,2,2,1,1,2023-03-27,2023-03-28,0,1
99999.0,8200016,2,2,1,1,2023-02-15,2023-02-21,0,6
99999.0,8200016,1,1,1,1,2023-02-15,2023-03-27,0,40
99999.0,8200016,4,4,1,1,2023-02-15,2023-02-17,0,2
99999.0,8200016,1,1,1,1,2023-02-15,2023-03-07,0,20
99999.0,8200016,2,2,1,1,2023-02-15,2023-02-28,0,13
99999.0,8200016,2,2,1,1,2023-02-15,2023-03-13,0,26
99999.0,8200016,2,2,1,1,2023-02-15,2023-03-28,0,41
99999.0,8200016,12,12,3,3,2023-02-10,2023-02-13,0,3
99999.0,8200016,4,4,3,3,2023-02-10,2023-02-17,0,7
99999.0,8200016,3,3,3,3,2023-02-10,2023-02-15,0,5
99999.0,8200016,4,4,3,3,2023-02-15,2023-02-17,0,2
99999.0,8200016,10,10,2,2,2023-01-17,2023-02-03,0,17
99999.0,8200016,2,2,2,2,2023-01-17,2023-02-21,0,35
99999.0,8200016,12,12,2,2,2023-01-17,2023-02-13,0,27
99999.0,8200016,3,3,2,2,2023-01-17,2023-02-10,0,24
99999.0,8200016,4,4,2,2,2023-01-17,2023-02-17,0,31
99999.0,8200016,3,3,2,2,2023-01-17,2023-02-15,0,29
99999.0,8200016,8,8,2,2,2023-01-17,2023-01-27,0,10
99999.0,8200016,3,3,2,2,2023-01-17,2023-02-09,0,23
99999.0,8200016,12,0,2,2,2023-01-17,2023-02-10,0,24
99999.0,8200016,2,2,2,2,2023-01-17,2023-02-28,0,42
99999.0,8200016,2,2,2,2,2023-01-17,2023-03-13,0,55
99999.0,8200016,10,10,2,2,2023-01-10,2023-02-03,0,24
99999.0,8200016,2,2,2,2,2023-01-10,2023-02-21,0,42
99999.0,8200016,12,12,2,2,2023-01-10,2023-02-13,0,34
99999.0,8200016,3,3,2,2,2023-01-10,2023-02-10,0,31
99999.0,8200016,4,4,2,2,2023-01-10,2023-02-17,0,38
99999.0,8200016,3,3,2,2,2023-01-10,2023-02-15,0,36
99999.0,8200016,2,2,2,2,2023-01-10,2023-01-17,0,7
99999.0,8200016,8,8,2,2,2023-01-10,2023-01-27,0,17
99999.0,8200016,3,3,2,2,2023-01-10,2023-02-09,0,30
99999.0,8200016,12,0,2,2,2023-01-10,2023-02-10,0,31
99999.0,8200016,2,2,2,2,2023-01-10,2023-02-28,0,49
99999.0,8200016,10,10,1,1,2023-01-11,2023-02-03,0,23
99999.0,8200016,1,1,1,1,2023-01-11,2023-02-02,0,22
99999.0,8200016,2,2,1,1,2023-01-11,2023-02-21,0,41
99999.0,8200016,1,1,1,1,2023-01-11,2023-02-15,0,35
99999.0,8200016,12,12,1,1,2023-01-11,2023-02-13,0,33
99999.0,8200016,3,3,1,1,2023-01-11,2023-02-10,0,30
99999.0,8200016,4,4,1,1,2023-01-11,2023-02-17,0,37
99999.0,8200016,3,3,1,1,2023-01-11,2023-02-15,0,35
99999.0,8200016,2,2,1,1,2023-01-11,2023-01-17,0,6
99999.0,8200016,8,8,1,1,2023-01-11,2023-01-27,0,16
99999.0,8200016,1,1,1,1,2023-01-11,2023-03-07,0,55
99999.0,8200016,3,3,1,1,2023-01-11,2023-02-09,0,29
99999.0,8200016,12,0,1,1,2023-01-11,2023-02-10,0,30
99999.0,8200016,2,2,1,1,2023-01-11,2023-02-28,0,48
99999.0,8200016,10,10,8,8,2023-01-27,2023-02-03,0,7
99999.0,8200016,12,12,8,8,2023-01-27,2023-02-13,0,17
99999.0,8200016,12,0,8,8,2023-01-27,2023-02-10,0,14
99999.0,8200016,1,1,1,1,2023-03-07,2023-03-27,0,20
99999.0,8200016,2,2,1,1,2023-03-07,2023-03-13,0,6
99999.0,8200016,2,2,1,1,2023-03-07,2023-03-28,0,21
99999.0,8200016,12,12,3,3,2023-02-09,2023-02-13,0,4
99999.0,8200016,3,3,3,3,2023-02-09,2023-02-10,0,1
99999.0,8200016,4,4,3,3,2023-02-09,2023-02-17,0,8
99999.0,8200016,3,3,3,3,2023-02-09,2023-02-15,0,6
99999.0,8200016,12,0,3,3,2023-02-09,2023-02-10,0,1
99999.0,8200016,2,2,12,0,2023-02-10,2023-02-21,12,11
99999.0,8200016,1,1,12,0,2023-02-10,2023-03-27,12,45
99999.0,8200016,1,1,12,0,2023-02-10,2023-02-15,12,5
99999.0,8200016,12,12,12,0,2023-02-10,2023-02-13,12,3
99999.0,8200016,4,4,12,0,2023-02-10,2023-02-17,12,7
99999.0,8200016,3,3,12,0,2023-02-10,2023-02-15,12,5
99999.0,8200016,1,1,12,0,2023-02-10,2023-03-07,12,25
99999.0,8200016,2,2,12,0,2023-02-10,2023-02-28,12,18
99999.0,8200016,2,2,12,0,2023-02-10,2023-03-13,12,31
99999.0,8200016,2,2,12,0,2023-02-10,2023-03-28,12,46
99999.0,8200016,2,2,2,2,2023-02-28,2023-03-13,0,13
99999.0,8200016,2,2,2,2,2023-02-28,2023-03-28,0,28
99999.0,8200016,2,2,2,2,2023-03-13,2023-03-28,0,15
99999.0,8202012,1,1,1,1,2023-02-21,2023-02-27,0,6
99999.0,8202012,1,1,1,1,2023-02-21,2023-02-22,0,1
99999.0,8202012,1,1,1,1,2023-01-11,2023-02-21,0,41
99999.0,8202012,1,0,1,1,2023-01-11,2023-02-14,0,34
99999.0,8202012,1,1,1,1,2023-01-11,2023-02-02,0,22
99999.0,8202012,1,1,1,1,2023-01-11,2023-02-27,0,47
99999.0,8202012,1,1,1,1,2023-01-11,2023-01-18,0,7
99999.0,8202012,1,1,1,1,2023-01-11,2023-02-22,0,42
99999.0,8202012,1,1,1,0,2023-02-14,2023-02-21,1,7
99999.0,8202012,1,1,1,0,2023-02-14,2023-02-27,1,13
99999.0,8202012,1,1,1,0,2023-02-14,2023-02-22,1,8
99999.0,8202012,1,1,1,1,2023-02-02,2023-02-21,0,19
99999.0,8202012,1,0,1,1,2023-02-02,2023-02-14,0,12
99999.0,8202012,1,1,1,1,2023-02-02,2023-02-27,0,25
99999.0,8202012,1,1,1,1,2023-02-02,2023-02-22,0,20
99999.0,8202012,1,1,1,1,2023-01-18,2023-02-21,0,34
99999.0,8202012,1,0,1,1,2023-01-18,2023-02-14,0,27
99999.0,8202012,1,1,1,1,2023-01-18,2023-02-02,0,15
99999.0,8202012,1,1,1,1,2023-01-18,2023-02-27,0,40
99999.0,8202012,1,1,1,1,2023-01-18,2023-02-22,0,35
99999.0,8202012,1,1,1,1,2023-01-10,2023-02-21,0,42
99999.0,8202012,1,1,1,1,2023-01-10,2023-01-11,0,1
99999.0,8202012,1,0,1,1,2023-01-10,2023-02-14,0,35
99999.0,8202012,1,1,1,1,2023-01-10,2023-02-02,0,23
99999.0,8202012,1,1,1,1,2023-01-10,2023-02-27,0,48
99999.0,8202012,1,1,1,1,2023-01-10,2023-01-18,0,8
99999.0,8202012,1,1,1,1,2023-01-10,2023-02-22,0,43
99999.0,8202012,1,1,1,1,2023-02-22,2023-02-27,0,5
99999.0,8213019,12,12,12,12,2022-12-15,2023-01-12,0,28
99999.0,8213019,12,12,12,12,2022-12-15,2023-01-17,0,33
99999.0,8213019,12,12,12,12,2022-12-15,2023-01-16,0,32
99999.0,8213019,24,24,12,12,2022-12-08,2022-12-15,0,7
99999.0,8213019,12,12,12,12,2022-12-08,2022-12-15,0,7
99999.0,8213019,12,12,12,12,2022-12-08,2023-01-12,0,35
99999.0,8213019,12,12,12,12,2022-12-08,2023-01-17,0,40
99999.0,8213019,12,12,12,12,2022-12-08,2023-01-16,0,39
99999.0,8213019,24,24,12,12,2023-01-12,2023-02-17,0,36
99999.0,8213019,12,12,12,12,2023-01-12,2023-01-17,0,5
99999.0,8213019,12,12,12,12,2023-01-12,2023-01-16,0,4
99999.0,8213019,24,24,12,12,2023-01-17,2023-02-17,0,31
99999.0,8213019,24,24,12,12,2023-01-16,2023-02-17,0,32
99999.0,8213019,12,12,12,12,2023-01-16,2023-01-17,0,1
99999.0,8214017,12,12,12,12,2022-12-15,2023-01-12,0,28
99999.0,8214017,12,12,12,12,2022-12-15,2023-02-10,0,57
99999.0,8214017,12,12,12,12,2022-12-08,2022-12-15,0,7
99999.0,8214017,12,12,12,12,2022-12-08,2023-01-12,0,35
99999.0,8214017,12,12,12,12,2023-01-12,2023-02-17,0,36
99999.0,8214017,12,12,12,12,2023-01-12,2023-02-10,0,29
99999.0,8214017,24,24,12,12,2023-02-17,2023-03-21,0,32
99999.0,8214017,12,12,12,12,2023-02-10,2023-02-17,0,7
99999.0,8214017,24,24,12,12,2023-02-10,2023-03-21,0,39
99999.0,8215015,12,12,12,0,2023-01-19,2023-02-17,12,29
99999.0,8215015,12,12,12,12,2023-01-19,2023-02-17,0,29
99999.0,8215015,12,0,12,12,2023-01-16,2023-01-19,0,3
99999.0,8215015,12,12,12,12,2023-01-16,2023-01-19,0,3
99999.0,8215015,12,12,12,12,2023-01-16,2023-02-17,0,32
99999.0,8217011,36,36,36,36,2023-01-17,2023-03-01,0,43
99999.0,8217011,36,36,36,36,2023-01-17,2023-01-27,0,10
99999.0,8217011,36,36,36,36,2023-01-17,2023-02-21,0,35
99999.0,8217011,36,36,36,36,2023-01-27,2023-03-01,0,33
99999.0,8217011,36,36,36,36,2023-01-27,2023-02-21,0,25
99999.0,8217011,36,36,36,36,2023-02-21,2023-03-01,0,8
99999.0,8218019,28,28,28,28,2022-12-15,2023-02-09,0,56
99999.0,8218019,28,28,28,28,2022-12-15,2023-02-10,0,57
99999.0,8218019,28,28,28,28,2023-02-21,2023-03-01,0,8
99999.0,8218019,28,28,28,28,2023-02-09,2023-02-21,0,12
99999.0,8218019,28,28,28,28,2023-02-09,2023-03-01,0,20
99999.0,8218019,28,28,28,28,2023-02-09,2023-02-10,0,1
99999.0,8218019,28,28,28,28,2023-02-09,2023-02-21,0,12
99999.0,8218019,28,28,28,28,2023-02-10,2023-02-21,0,11
99999.0,8218019,28,28,28,28,2023-02-10,2023-03-01,0,19
99999.0,8218019,28,28,28,28,2023-02-10,2023-02-21,0,11
99999.0,8218019,28,28,28,28,2023-02-21,2023-03-01,0,8
99999.0,8220014,20,20,4,4,2022-12-01,2023-01-09,0,39
99999.0,8220014,11,11,4,4,2022-12-01,2023-01-27,0,57
99999.0,8220014,12,12,5,5,2023-02-03,2023-02-10,0,7
99999.0,8220014,11,11,5,5,2023-02-03,2023-02-22,0,19
99999.0,8220014,12,0,5,5,2023-02-03,2023-02-09,0,6
99999.0,8220014,4,4,1,1,2023-02-15,2023-03-14,0,27
99999.0,8220014,11,11,1,1,2023-02-15,2023-02-22,0,7
99999.0,8220014,12,12,11,11,2023-01-27,2023-02-10,0,14
99999.0,8220014,11,11,11,11,2023-01-27,2023-02-22,0,26
99999.0,8220014,12,0,11,11,2023-01-27,2023-02-09,0,13
99999.0,8220014,4,4,12,0,2023-02-09,2023-03-14,12,33
99999.0,8220014,12,12,12,0,2023-02-09,2023-02-10,12,1
99999.0,8220014,1,1,12,0,2023-02-09,2023-02-15,12,6
99999.0,8220014,11,11,12,0,2023-02-09,2023-02-22,12,13
99999.0,8221012,360,360,96,96,2022-12-08,2022-12-15,0,7
99999.0,8221012,284,0,96,96,2022-12-08,2023-01-19,0,42
99999.0,8221012,284,284,96,96,2022-12-08,2023-01-19,0,42
99999.0,8221012,204,204,96,96,2022-12-08,2023-01-16,0,39
99999.0,8221012,480,480,24,24,2023-02-01,2023-02-21,0,20
99999.0,8221012,176,176,24,24,2023-02-01,2023-02-17,0,16
99999.0,8221012,136,136,24,24,2023-02-01,2023-02-15,0,14
99999.0,8221012,180,180,24,24,2023-02-01,2023-03-13,0,40
99999.0,8221012,112,112,24,24,2023-02-01,2023-03-01,0,28
99999.0,8221012,24,24,24,24,2023-02-01,2023-02-09,0,8
99999.0,8221012,60,60,24,24,2023-02-01,2023-02-10,0,9
99999.0,8221012,548,548,24,24,2023-02-01,2023-03-21,0,48
99999.0,8221012,36,36,24,24,2023-02-01,2023-03-13,0,40
99999.0,8221012,36,36,24,24,2023-02-01,2023-03-27,0,54
99999.0,8221012,480,480,40,40,2023-01-12,2023-02-21,0,40
99999.0,8221012,284,0,40,40,2023-01-12,2023-01-19,0,7
99999.0,8221012,284,284,40,40,2023-01-12,2023-01-19,0,7
99999.0,8221012,176,176,40,40,2023-01-12,2023-02-17,0,36
99999.0,8221012,204,204,40,40,2023-01-12,2023-01-16,0,4
99999.0,8221012,136,136,40,40,2023-01-12,2023-02-15,0,34
99999.0,8221012,72,72,40,40,2023-01-12,2023-01-27,0,15
99999.0,8221012,180,180,40,40,2023-01-12,2023-03-13,0,60
99999.0,8221012,112,112,40,40,2023-01-12,2023-03-01,0,48
99999.0,8221012,60,60,40,40,2023-01-12,2023-02-10,0,29
99999.0,8221012,548,548,480,480,2023-02-21,2023-03-21,0,28
99999.0,8221012,480,480,16,16,2023-02-14,2023-02-21,0,7
99999.0,8221012,176,176,16,16,2023-02-14,2023-02-17,0,3
99999.0,8221012,136,136,16,16,2023-02-14,2023-02-15,0,1
99999.0,8221012,180,180,16,16,2023-02-14,2023-03-13,0,27
99999.0,8221012,112,112,16,16,2023-02-14,2023-03-01,0,15
99999.0,8221012,548,548,16,16,2023-02-14,2023-03-21,0,35
99999.0,8221012,36,36,16,16,2023-02-14,2023-03-13,0,27
99999.0,8221012,20,20,16,16,2023-02-14,2023-02-23,0,9
99999.0,8221012,36,36,16,16,2023-02-14,2023-03-27,0,41
99999.0,8221012,24,24,284,0,2023-01-19,2023-02-01,284,13
99999.0,8221012,480,480,284,0,2023-01-19,2023-02-21,284,33
99999.0,8221012,16,16,284,0,2023-01-19,2023-02-14,284,26
99999.0,8221012,176,176,284,0,2023-01-19,2023-02-17,284,29
99999.0,8221012,20,20,284,0,2023-01-19,2023-02-13,284,25
99999.0,8221012,136,136,284,0,2023-01-19,2023-02-15,284,27
99999.0,8221012,72,72,284,0,2023-01-19,2023-01-27,284,8
99999.0,8221012,180,180,284,0,2023-01-19,2023-03-13,284,53
99999.0,8221012,112,112,284,0,2023-01-19,2023-03-01,284,41
99999.0,8221012,12,12,284,0,2023-01-19,2023-02-27,284,39
99999.0,8221012,24,24,284,0,2023-01-19,2023-02-09,284,21
99999.0,8221012,60,60,284,0,2023-01-19,2023-02-10,284,22
99999.0,8221012,36,36,284,0,2023-01-19,2023-03-13,284,53
99999.0,8221012,20,20,284,0,2023-01-19,2023-02-23,284,35
99999.0,8221012,480,480,284,284,2023-01-19,2023-02-21,0,33
99999.0,8221012,480,480,176,176,2023-02-17,2023-02-21,0,4
99999.0,8221012,180,180,176,176,2023-02-17,2023-03-13,0,24
99999.0,8221012,548,548,176,176,2023-02-17,2023-03-21,0,32
99999.0,8221012,480,480,20,20,2023-02-13,2023-02-21,0,8
99999.0,8221012,176,176,20,20,2023-02-13,2023-02-17,0,4
99999.0,8221012,136,136,20,20,2023-02-13,2023-02-15,0,2
99999.0,8221012,180,180,20,20,2023-02-13,2023-03-13,0,28
99999.0,8221012,112,112,20,20,2023-02-13,2023-03-01,0,16
99999.0,8221012,548,548,20,20,2023-02-13,2023-03-21,0,36
99999.0,8221012,36,36,20,20,2023-02-13,2023-03-13,0,28
99999.0,8221012,20,20,20,20,2023-02-13,2023-02-23,0,10
99999.0,8221012,36,36,20,20,2023-02-13,2023-03-27,0,42
99999.0,8221012,480,480,204,204,2023-01-16,2023-02-21,0,36
99999.0,8221012,284,0,204,204,2023-01-16,2023-01-19,0,3
99999.0,8221012,284,284,204,204,2023-01-16,2023-01-19,0,3
99999.0,8221012,480,480,136,136,2023-02-15,2023-02-21,0,6
99999.0,8221012,176,176,136,136,2023-02-15,2023-02-17,0,2
99999.0,8221012,180,180,136,136,2023-02-15,2023-03-13,0,26
99999.0,8221012,548,548,136,136,2023-02-15,2023-03-21,0,34
99999.0,8221012,40,40,32,32,2023-01-10,2023-01-12,0,2
99999.0,8221012,480,480,32,32,2023-01-10,2023-02-21,0,42
99999.0,8221012,284,0,32,32,2023-01-10,2023-01-19,0,9
99999.0,8221012,284,284,32,32,2023-01-10,2023-01-19,0,9
99999.0,8221012,176,176,32,32,2023-01-10,2023-02-17,0,38
99999.0,8221012,204,204,32,32,2023-01-10,2023-01-16,0,6
99999.0,8221012,136,136,32,32,2023-01-10,2023-02-15,0,36
99999.0,8221012,72,72,32,32,2023-01-10,2023-01-27,0,17
99999.0,8221012,112,112,32,32,2023-01-10,2023-03-01,0,50
99999.0,8221012,60,60,32,32,2023-01-10,2023-02-10,0,31
99999.0,8221012,480,480,72,72,2023-01-27,2023-02-21,0,25
99999.0,8221012,176,176,72,72,2023-01-27,2023-02-17,0,21
99999.0,8221012,136,136,72,72,2023-01-27,2023-02-15,0,19
99999.0,8221012,180,180,72,72,2023-01-27,2023-03-13,0,45
99999.0,8221012,112,112,72,72,2023-01-27,2023-03-01,0,33
99999.0,8221012,548,548,72,72,2023-01-27,2023-03-21,0,53
99999.0,8221012,548,548,180,180,2023-03-13,2023-03-21,0,8
99999.0,8221012,180,180,112,112,2023-03-01,2023-03-13,0,12
99999.0,8221012,548,548,112,112,2023-03-01,2023-03-21,0,20
99999.0,8221012,12,12,12,12,2023-02-27,2023-03-27,0,28
99999.0,8221012,180,180,12,12,2023-02-27,2023-03-13,0,14
99999.0,8221012,112,112,12,12,2023-02-27,2023-03-01,0,2
99999.0,8221012,548,548,12,12,2023-02-27,2023-03-21,0,22
99999.0,8221012,36,36,12,12,2023-02-27,2023-03-13,0,14
99999.0,8221012,36,36,12,12,2023-02-27,2023-03-27,0,28
99999.0,8221012,480,480,24,24,2023-02-09,2023-02-21,0,12
99999.0,8221012,176,176,24,24,2023-02-09,2023-02-17,0,8
99999.0,8221012,136,136,24,24,2023-02-09,2023-02-15,0,6
99999.0,8221012,180,180,24,24,2023-02-09,2023-03-13,0,32
99999.0,8221012,112,112,24,24,2023-02-09,2023-03-01,0,20
99999.0,8221012,60,60,24,24,2023-02-09,2023-02-10,0,1
99999.0,8221012,548,548,24,24,2023-02-09,2023-03-21,0,40
99999.0,8221012,36,36,24,24,2023-02-09,2023-03-13,0,32
99999.0,8221012,36,36,24,24,2023-02-09,2023-03-27,0,46
99999.0,8221012,480,480,60,60,2023-02-10,2023-02-21,0,11
99999.0,8221012,176,176,60,60,2023-02-10,2023-02-17,0,7
99999.0,8221012,136,136,60,60,2023-02-10,2023-02-15,0,5
99999.0,8221012,180,180,60,60,2023-02-10,2023-03-13,0,31
99999.0,8221012,112,112,60,60,2023-02-10,2023-03-01,0,19
99999.0,8221012,548,548,60,60,2023-02-10,2023-03-21,0,39
99999.0,8221012,548,548,36,36,2023-03-13,2023-03-21,0,8
99999.0,8221012,36,36,36,36,2023-03-13,2023-03-27,0,14
99999.0,8221012,180,180,20,20,2023-02-23,2023-03-13,0,18
99999.0,8221012,112,112,20,20,2023-02-23,2023-03-01,0,6
99999.0,8221012,548,548,20,20,2023-02-23,2023-03-21,0,26
99999.0,8221012,36,36,20,20,2023-02-23,2023-03-13,0,18
99999.0,8221012,36,36,20,20,2023-02-23,2023-03-27,0,32
99999.0,8222010,96,96,72,72,2022-12-20,2023-02-17,0,59
99999.0,8222010,36,36,24,24,2022-12-28,2023-02-21,0,55
99999.0,8222010,24,24,24,24,2022-12-28,2023-02-14,0,48
99999.0,8222010,24,24,24,24,2022-12-28,2023-02-15,0,49
99999.0,8222010,60,0,24,24,2022-12-28,2023-01-19,0,22
99999.0,8222010,60,60,24,24,2022-12-28,2023-01-19,0,22
99999.0,8222010,96,96,24,24,2022-12-28,2023-02-17,0,51
99999.0,8222010,34,34,24,24,2022-12-28,2023-02-15,0,49
99999.0,8222010,24,24,24,24,2022-12-28,2023-01-10,0,13
99999.0,8222010,48,48,24,24,2022-12-28,2023-02-23,0,57
99999.0,8222010,168,168,36,36,2022-12-08,2022-12-15,0,7
99999.0,8222010,72,72,36,36,2022-12-08,2022-12-20,0,12
99999.0,8222010,144,144,36,36,2022-12-08,2022-12-15,0,7
99999.0,8222010,60,0,36,36,2022-12-08,2023-01-19,0,42
99999.0,8222010,60,60,36,36,2022-12-08,2023-01-19,0,42
99999.0,8222010,36,36,12,12,2023-01-12,2023-02-21,0,40
99999.0,8222010,24,24,12,12,2023-01-12,2023-02-14,0,33
99999.0,8222010,24,24,12,12,2023-01-12,2023-02-15,0,34
99999.0,8222010,60,0,12,12,2023-01-12,2023-01-19,0,7
99999.0,8222010,60,60,12,12,2023-01-12,2023-01-19,0,7
99999.0,8222010,96,96,12,12,2023-01-12,2023-02-17,0,36
99999.0,8222010,34,34,12,12,2023-01-12,2023-02-15,0,34
99999.0,8222010,48,48,12,12,2023-01-12,2023-02-23,0,42
99999.0,8222010,24,24,12,12,2023-01-12,2023-03-13,0,60
99999.0,8222010,24,24,12,12,2023-01-12,2023-03-01,0,48
99999.0,8222010,36,36,12,12,2023-01-12,2023-03-13,0,60
99999.0,8222010,12,12,12,12,2023-01-12,2023-02-23,0,42
99999.0,8222010,48,48,36,36,2023-02-21,2023-02-23,0,2
99999.0,8222010,132,132,36,36,2023-02-21,2023-03-21,0,28
99999.0,8222010,36,36,36,36,2023-02-21,2023-03-13,0,20
99999.0,8222010,36,36,24,24,2023-02-14,2023-02-21,0,7
99999.0,8222010,24,24,24,24,2023-02-14,2023-02-15,0,1
99999.0,8222010,96,96,24,24,2023-02-14,2023-02-17,0,3
99999.0,8222010,34,34,24,24,2023-02-14,2023-02-15,0,1
99999.0,8222010,48,48,24,24,2023-02-14,2023-02-23,0,9
99999.0,8222010,24,24,24,24,2023-02-14,2023-03-13,0,27
99999.0,8222010,24,24,24,24,2023-02-14,2023-03-01,0,15
99999.0,8222010,132,132,24,24,2023-02-14,2023-03-21,0,35
99999.0,8222010,36,36,24,24,2023-02-14,2023-03-13,0,27
99999.0,8222010,24,24,24,24,2023-02-14,2023-03-27,0,41
99999.0,8222010,36,36,24,24,2023-02-15,2023-02-21,0,6
99999.0,8222010,96,96,24,24,2023-02-15,2023-02-17,0,2
99999.0,8222010,48,48,24,24,2023-02-15,2023-02-23,0,8
99999.0,8222010,24,24,24,24,2023-02-15,2023-03-13,0,26
99999.0,8222010,24,24,24,24,2023-02-15,2023-03-01,0,14
99999.0,8222010,132,132,24,24,2023-02-15,2023-03-21,0,34
99999.0,8222010,36,36,24,24,2023-02-15,2023-03-13,0,26
99999.0,8222010,24,24,24,24,2023-02-15,2023-03-27,0,40
99999.0,8222010,36,36,60,0,2023-01-19,2023-02-21,60,33
99999.0,8222010,24,24,60,0,2023-01-19,2023-02-14,60,26
99999.0,8222010,24,24,60,0,2023-01-19,2023-02-15,60,27
99999.0,8222010,96,96,60,0,2023-01-19,2023-02-17,60,29
99999.0,8222010,34,34,60,0,2023-01-19,2023-02-15,60,27
99999.0,8222010,48,48,60,0,2023-01-19,2023-02-23,60,35
99999.0,8222010,24,24,60,0,2023-01-19,2023-03-13,60,53
99999.0,8222010,24,24,60,0,2023-01-19,2023-03-01,60,41
99999.0,8222010,36,36,60,0,2023-01-19,2023-03-13,60,53
99999.0,8222010,12,12,60,0,2023-01-19,2023-02-23,60,35
99999.0,8222010,96,96,60,60,2023-01-19,2023-02-17,0,29
99999.0,8222010,132,132,96,96,2023-02-17,2023-03-21,0,32
99999.0,8222010,36,36,34,34,2023-02-15,2023-02-21,0,6
99999.0,8222010,96,96,34,34,2023-02-15,2023-02-17,0,2
99999.0,8222010,48,48,34,34,2023-02-15,2023-02-23,0,8
99999.0,8222010,132,132,34,34,2023-02-15,2023-03-21,0,34
99999.0,8222010,36,36,34,34,2023-02-15,2023-03-13,0,26
99999.0,8222010,36,36,24,24,2023-01-10,2023-02-21,0,42
99999.0,8222010,24,24,24,24,2023-01-10,2023-02-14,0,35
99999.0,8222010,24,24,24,24,2023-01-10,2023-02-15,0,36
99999.0,8222010,60,0,24,24,2023-01-10,2023-01-19,0,9
99999.0,8222010,60,60,24,24,2023-01-10,2023-01-19,0,9
99999.0,8222010,96,96,24,24,2023-01-10,2023-02-17,0,38
99999.0,8222010,34,34,24,24,2023-01-10,2023-02-15,0,36
99999.0,8222010,48,48,24,24,2023-01-10,2023-02-23,0,44
99999.0,8222010,24,24,24,24,2023-01-10,2023-03-01,0,50
99999.0,8222010,132,132,48,48,2023-02-23,2023-03-21,0,26
99999.0,8222010,132,132,24,24,2023-03-13,2023-03-21,0,8
99999.0,8222010,24,24,24,24,2023-03-13,2023-03-27,0,14
99999.0,8222010,24,24,24,24,2023-03-01,2023-03-13,0,12
99999.0,8222010,132,132,24,24,2023-03-01,2023-03-21,0,20
99999.0,8222010,36,36,24,24,2023-03-01,2023-03-13,0,12
99999.0,8222010,24,24,24,24,2023-03-01,2023-03-27,0,26
99999.0,8222010,132,132,36,36,2023-03-13,2023-03-21,0,8
99999.0,8222010,24,24,12,12,2023-02-23,2023-03-13,0,18
99999.0,8222010,24,24,12,12,2023-02-23,2023-03-01,0,6
99999.0,8222010,132,132,12,12,2023-02-23,2023-03-21,0,26
99999.0,8222010,36,36,12,12,2023-02-23,2023-03-13,0,18
99999.0,8222010,24,24,12,12,2023-02-23,2023-03-27,0,32
99999.0,8223018,2876,2876,200,200,2022-12-15,2023-02-01,0,48
99999.0,8223018,274,274,200,200,2022-12-15,2023-01-19,0,35
99999.0,8223018,240,240,200,200,2022-12-15,2023-01-16,0,32
99999.0,8223018,40,40,12,12,2022-12-23,2022-12-28,0,5
99999.0,8223018,2876,2876,12,12,2022-12-23,2023-02-01,0,40
99999.0,8223018,196,196,12,12,2022-12-23,2023-01-12,0,20
99999.0,8223018,480,480,12,12,2022-12-23,2023-02-21,0,60
99999.0,8223018,40,40,12,12,2022-12-23,2023-01-18,0,26
99999.0,8223018,48,48,12,12,2022-12-23,2023-02-14,0,53
99999.0,8223018,40,40,12,12,2022-12-23,2023-01-18,0,26
99999.0,8223018,60,60,12,12,2022-12-23,2023-01-04,0,12
99999.0,8223018,40,40,12,12,2022-12-23,2023-02-15,0,54
99999.0,8223018,274,274,12,12,2022-12-23,2023-01-19,0,27
99999.0,8223018,28,28,12,12,2022-12-23,2023-01-09,0,17
99999.0,8223018,120,120,12,12,2022-12-23,2023-02-13,0,52
99999.0,8223018,240,240,12,12,2022-12-23,2023-01-16,0,24
99999.0,8223018,60,60,12,12,2022-12-23,2023-01-17,0,25
99999.0,8223018,48,48,12,12,2022-12-23,2023-01-10,0,18
99999.0,8223018,264,264,12,12,2022-12-23,2023-02-15,0,54
99999.0,8223018,160,160,12,12,2022-12-23,2023-01-27,0,35
99999.0,8223018,140,140,12,12,2022-12-23,2023-02-09,0,48
99999.0,8223018,60,60,12,12,2022-12-23,2023-02-10,0,49
99999.0,8223018,72,72,12,12,2022-12-23,2023-02-21,0,60
99999.0,8223018,2876,2876,124,124,2022-12-20,2023-02-01,0,43
99999.0,8223018,196,196,124,124,2022-12-20,2023-01-12,0,23
99999.0,8223018,274,274,124,124,2022-12-20,2023-01-19,0,30
99999.0,8223018,240,240,124,124,2022-12-20,2023-01-16,0,27
99999.0,8223018,264,264,124,124,2022-12-20,2023-02-15,0,57
99999.0,8223018,160,160,124,124,2022-12-20,2023-01-27,0,38
99999.0,8223018,140,140,124,124,2022-12-20,2023-02-09,0,51
99999.0,8223018,200,200,48,0,2022-11-14,2022-12-15,48,31
99999.0,8223018,12,12,48,0,2022-11-14,2022-12-23,48,39
99999.0,8223018,124,124,48,0,2022-11-14,2022-12-20,48,36
99999.0,8223018,40,40,48,0,2022-11-14,2022-12-28,48,44
99999.0,8223018,300,300,48,0,2022-11-14,2022-12-15,48,31
99999.0,8223018,120,120,48,0,2022-11-14,2022-12-08,48,24
99999.0,8223018,196,196,48,0,2022-11-14,2023-01-12,48,59
99999.0,8223018,60,60,48,0,2022-11-14,2023-01-04,48,51
99999.0,8223018,28,28,48,0,2022-11-14,2023-01-09,48,56
99999.0,8223018,48,48,48,0,2022-11-14,2023-01-10,48,57
99999.0,8223018,2876,2876,40,40,2022-12-28,2023-02-01,0,35
99999.0,8223018,196,196,40,40,2022-12-28,2023-01-12,0,15
99999.0,8223018,480,480,40,40,2022-12-28,2023-02-21,0,55
99999.0,8223018,40,40,40,40,2022-12-28,2023-01-18,0,21
99999.0,8223018,48,48,40,40,2022-12-28,2023-02-14,0,48
99999.0,8223018,40,40,40,40,2022-12-28,2023-01-18,0,21
99999.0,8223018,60,60,40,40,2022-12-28,2023-01-04,0,7
99999.0,8223018,40,40,40,40,2022-12-28,2023-02-15,0,49
99999.0,8223018,274,274,40,40,2022-12-28,2023-01-19,0,22
99999.0,8223018,120,120,40,40,2022-12-28,2023-02-13,0,47
99999.0,8223018,240,240,40,40,2022-12-28,2023-01-16,0,19
99999.0,8223018,60,60,40,40,2022-12-28,2023-01-17,0,20
99999.0,8223018,48,48,40,40,2022-12-28,2023-01-10,0,13
99999.0,8223018,264,264,40,40,2022-12-28,2023-02-15,0,49
99999.0,8223018,160,160,40,40,2022-12-28,2023-01-27,0,30
99999.0,8223018,84,84,40,40,2022-12-28,2023-02-23,0,57
99999.0,8223018,140,140,40,40,2022-12-28,2023-02-09,0,43
99999.0,8223018,60,60,40,40,2022-12-28,2023-02-10,0,44
99999.0,8223018,72,72,40,40,2022-12-28,2023-02-21,0,55
99999.0,8223018,60,60,40,40,2022-12-28,2023-02-23,0,57
99999.0,8223018,2876,2876,300,300,2022-12-15,2023-02-01,0,48
99999.0,8223018,200,200,120,120,2022-12-08,2022-12-15,0,7
99999.0,8223018,124,124,120,120,2022-12-08,2022-12-20,0,12
99999.0,8223018,300,300,120,120,2022-12-08,2022-12-15,0,7
99999.0,8223018,2876,2876,120,120,2022-12-08,2023-02-01,0,55
99999.0,8223018,196,196,120,120,2022-12-08,2023-01-12,0,35
99999.0,8223018,274,274,120,120,2022-12-08,2023-01-19,0,42
99999.0,8223018,240,240,120,120,2022-12-08,2023-01-16,0,39
99999.0,8223018,160,160,120,120,2022-12-08,2023-01-27,0,50
99999.0,8223018,2876,2876,196,196,2023-01-12,2023-02-01,0,20
99999.0,8223018,200,200,196,196,2023-01-12,2023-02-28,0,47
99999.0,8223018,480,480,196,196,2023-01-12,2023-02-21,0,40
99999.0,8223018,274,274,196,196,2023-01-12,2023-01-19,0,7
99999.0,8223018,240,240,196,196,2023-01-12,2023-01-16,0,4
99999.0,8223018,264,264,196,196,2023-01-12,2023-02-15,0,34
99999.0,8223018,2876,2876,40,40,2023-01-18,2023-02-01,0,14
99999.0,8223018,160,160,40,40,2023-01-18,2023-03-14,0,55
99999.0,8223018,200,200,40,40,2023-01-18,2023-02-28,0,41
99999.0,8223018,480,480,40,40,2023-01-18,2023-02-21,0,34
99999.0,8223018,48,48,40,40,2023-01-18,2023-02-14,0,27
99999.0,8223018,40,40,40,40,2023-01-18,2023-02-15,0,28
99999.0,8223018,274,274,40,40,2023-01-18,2023-01-19,0,1
99999.0,8223018,120,120,40,40,2023-01-18,2023-02-13,0,26
99999.0,8223018,264,264,40,40,2023-01-18,2023-02-15,0,28
99999.0,8223018,160,160,40,40,2023-01-18,2023-01-27,0,9
99999.0,8223018,84,84,40,40,2023-01-18,2023-02-23,0,36
99999.0,8223018,144,144,40,40,2023-01-18,2023-03-13,0,54
99999.0,8223018,124,124,40,40,2023-01-18,2023-03-01,0,42
99999.0,8223018,140,140,40,40,2023-01-18,2023-02-09,0,22
99999.0,8223018,60,60,40,40,2023-01-18,2023-02-10,0,23
99999.0,8223018,72,72,40,40,2023-01-18,2023-03-13,0,54
99999.0,8223018,72,72,40,40,2023-01-18,2023-02-21,0,34
99999.0,8223018,60,60,40,40,2023-01-18,2023-02-23,0,36
99999.0,8223018,156,156,40,40,2023-01-18,2023-03-08,0,49
99999.0,8223018,160,160,48,48,2023-02-14,2023-03-14,0,28
99999.0,8223018,200,200,48,48,2023-02-14,2023-02-28,0,14
99999.0,8223018,480,480,48,48,2023-02-14,2023-02-21,0,7
99999.0,8223018,264,264,48,48,2023-02-14,2023-02-15,0,1
99999.0,8223018,84,84,48,48,2023-02-14,2023-02-23,0,9
99999.0,8223018,144,144,48,48,2023-02-14,2023-03-13,0,27
99999.0,8223018,124,124,48,48,2023-02-14,2023-03-01,0,15
99999.0,8223018,72,72,48,48,2023-02-14,2023-03-13,0,27
99999.0,8223018,72,72,48,48,2023-02-14,2023-02-21,0,7
99999.0,8223018,60,60,48,48,2023-02-14,2023-02-23,0,9
99999.0,8223018,60,60,48,48,2023-02-14,2023-03-27,0,41
99999.0,8223018,156,156,48,48,2023-02-14,2023-03-08,0,22
99999.0,8223018,2876,2876,40,40,2023-01-18,2023-02-01,0,14
99999.0,8223018,160,160,40,40,2023-01-18,2023-03-14,0,55
99999.0,8223018,200,200,40,40,2023-01-18,2023-02-28,0,41
99999.0,8223018,480,480,40,40,2023-01-18,2023-02-21,0,34
99999.0,8223018,48,48,40,40,2023-01-18,2023-02-14,0,27
99999.0,8223018,40,40,40,40,2023-01-18,2023-02-15,0,28
99999.0,8223018,274,274,40,40,2023-01-18,2023-01-19,0,1
99999.0,8223018,120,120,40,40,2023-01-18,2023-02-13,0,26
99999.0,8223018,264,264,40,40,2023-01-18,2023-02-15,0,28
99999.0,8223018,160,160,40,40,2023-01-18,2023-01-27,0,9
99999.0,8223018,84,84,40,40,2023-01-18,2023-02-23,0,36
99999.0,8223018,144,144,40,40,2023-01-18,2023-03-13,0,54
99999.0,8223018,124,124,40,40,2023-01-18,2023-03-01,0,42
99999.0,8223018,140,140,40,40,2023-01-18,2023-02-09,0,22
99999.0,8223018,60,60,40,40,2023-01-18,2023-02-10,0,23
99999.0,8223018,72,72,40,40,2023-01-18,2023-03-13,0,54
99999.0,8223018,72,72,40,40,2023-01-18,2023-02-21,0,34
99999.0,8223018,60,60,40,40,2023-01-18,2023-02-23,0,36
99999.0,8223018,156,156,40,40,2023-01-18,2023-03-08,0,49
99999.0,8223018,2876,2876,60,60,2023-01-04,2023-02-01,0,28
99999.0,8223018,196,196,60,60,2023-01-04,2023-01-12,0,8
99999.0,8223018,200,200,60,60,2023-01-04,2023-02-28,0,55
99999.0,8223018,480,480,60,60,2023-01-04,2023-02-21,0,48
99999.0,8223018,274,274,60,60,2023-01-04,2023-01-19,0,15
99999.0,8223018,120,120,60,60,2023-01-04,2023-02-13,0,40
99999.0,8223018,240,240,60,60,2023-01-04,2023-01-16,0,12
99999.0,8223018,60,60,60,60,2023-01-04,2023-01-17,0,13
99999.0,8223018,264,264,60,60,2023-01-04,2023-02-15,0,42
99999.0,8223018,160,160,60,60,2023-01-04,2023-01-27,0,23
99999.0,8223018,84,84,60,60,2023-01-04,2023-02-23,0,50
99999.0,8223018,124,124,60,60,2023-01-04,2023-03-01,0,56
99999.0,8223018,140,140,60,60,2023-01-04,2023-02-09,0,36
99999.0,8223018,60,60,60,60,2023-01-04,2023-02-10,0,37
99999.0,8223018,72,72,60,60,2023-01-04,2023-02-21,0,48
99999.0,8223018,60,60,60,60,2023-01-04,2023-02-23,0,50
99999.0,8223018,160,160,40,40,2023-02-15,2023-03-14,0,27
99999.0,8223018,200,200,40,40,2023-02-15,2023-02-28,0,13
99999.0,8223018,480,480,40,40,2023-02-15,2023-02-21,0,6
99999.0,8223018,84,84,40,40,2023-02-15,2023-02-23,0,8
99999.0,8223018,144,144,40,40,2023-02-15,2023-03-13,0,26
99999.0,8223018,124,124,40,40,2023-02-15,2023-03-01,0,14
99999.0,8223018,72,72,40,40,2023-02-15,2023-03-13,0,26
99999.0,8223018,72,72,40,40,2023-02-15,2023-02-21,0,6
99999.0,8223018,60,60,40,40,2023-02-15,2023-02-23,0,8
99999.0,8223018,60,60,40,40,2023-02-15,2023-03-27,0,40
99999.0,8223018,156,156,40,40,2023-02-15,2023-03-08,0,21
99999.0,8223018,2876,2876,274,274,2023-01-19,2023-02-01,0,13
99999.0,8223018,480,480,274,274,2023-01-19,2023-02-21,0,33
99999.0,8223018,2876,2876,28,28,2023-01-09,2023-02-01,0,23
99999.0,8223018,196,196,28,28,2023-01-09,2023-01-12,0,3
99999.0,8223018,200,200,28,28,2023-01-09,2023-02-28,0,50
99999.0,8223018,480,480,28,28,2023-01-09,2023-02-21,0,43
99999.0,8223018,40,40,28,28,2023-01-09,2023-01-18,0,9
99999.0,8223018,48,48,28,28,2023-01-09,2023-02-14,0,36
99999.0,8223018,40,40,28,28,2023-01-09,2023-01-18,0,9
99999.0,8223018,40,40,28,28,2023-01-09,2023-02-15,0,37
99999.0,8223018,274,274,28,28,2023-01-09,2023-01-19,0,10
99999.0,8223018,120,120,28,28,2023-01-09,2023-02-13,0,35
99999.0,8223018,240,240,28,28,2023-01-09,2023-01-16,0,7
99999.0,8223018,60,60,28,28,2023-01-09,2023-01-17,0,8
99999.0,8223018,48,48,28,28,2023-01-09,2023-01-10,0,1
99999.0,8223018,264,264,28,28,2023-01-09,2023-02-15,0,37
99999.0,8223018,160,160,28,28,2023-01-09,2023-01-27,0,18
99999.0,8223018,84,84,28,28,2023-01-09,2023-02-23,0,45
99999.0,8223018,32,32,28,28,2023-01-09,2023-03-07,0,57
99999.0,8223018,124,124,28,28,2023-01-09,2023-03-01,0,51
99999.0,8223018,140,140,28,28,2023-01-09,2023-02-09,0,31
99999.0,8223018,60,60,28,28,2023-01-09,2023-02-10,0,32
99999.0,8223018,72,72,28,28,2023-01-09,2023-02-21,0,43
99999.0,8223018,60,60,28,28,2023-01-09,2023-02-23,0,45
99999.0,8223018,156,156,28,28,2023-01-09,2023-03-08,0,58
99999.0,8223018,160,160,120,120,2023-02-13,2023-03-14,0,29
99999.0,8223018,200,200,120,120,2023-02-13,2023-02-28,0,15
99999.0,8223018,480,480,120,120,2023-02-13,2023-02-21,0,8
99999.0,8223018,264,264,120,120,2023-02-13,2023-02-15,0,2
99999.0,8223018,144,144,120,120,2023-02-13,2023-03-13,0,28
99999.0,8223018,124,124,120,120,2023-02-13,2023-03-01,0,16
99999.0,8223018,156,156,120,120,2023-02-13,2023-03-08,0,23
99999.0,8223018,2876,2876,240,240,2023-01-16,2023-02-01,0,16
99999.0,8223018,480,480,240,240,2023-01-16,2023-02-21,0,36
99999.0,8223018,274,274,240,240,2023-01-16,2023-01-19,0,3
99999.0,8223018,264,264,240,240,2023-01-16,2023-02-15,0,30
99999.0,8223018,2876,2876,60,60,2023-01-17,2023-02-01,0,15
99999.0,8223018,160,160,60,60,2023-01-17,2023-03-14,0,56
99999.0,8223018,200,200,60,60,2023-01-17,2023-02-28,0,42
99999.0,8223018,480,480,60,60,2023-01-17,2023-02-21,0,35
99999.0,8223018,274,274,60,60,2023-01-17,2023-01-19,0,2
99999.0,8223018,120,120,60,60,2023-01-17,2023-02-13,0,27
99999.0,8223018,264,264,60,60,2023-01-17,2023-02-15,0,29
99999.0,8223018,160,160,60,60,2023-01-17,2023-01-27,0,10
99999.0,8223018,84,84,60,60,2023-01-17,2023-02-23,0,37
99999.0,8223018,144,144,60,60,2023-01-17,2023-03-13,0,55
99999.0,8223018,124,124,60,60,2023-01-17,2023-03-01,0,43
99999.0,8223018,140,140,60,60,2023-01-17,2023-02-09,0,23
99999.0,8223018,60,60,60,60,2023-01-17,2023-02-10,0,24
99999.0,8223018,72,72,60,60,2023-01-17,2023-03-13,0,55
99999.0,8223018,72,72,60,60,2023-01-17,2023-02-21,0,35
99999.0,8223018,60,60,60,60,2023-01-17,2023-02-23,0,37
99999.0,8223018,156,156,60,60,2023-01-17,2023-03-08,0,50
99999.0,8223018,2876,2876,48,48,2023-01-10,2023-02-01,0,22
99999.0,8223018,196,196,48,48,2023-01-10,2023-01-12,0,2
99999.0,8223018,200,200,48,48,2023-01-10,2023-02-28,0,49
99999.0,8223018,480,480,48,48,2023-01-10,2023-02-21,0,42
99999.0,8223018,48,48,48,48,2023-01-10,2023-02-14,0,35
99999.0,8223018,274,274,48,48,2023-01-10,2023-01-19,0,9
99999.0,8223018,120,120,48,48,2023-01-10,2023-02-13,0,34
99999.0,8223018,240,240,48,48,2023-01-10,2023-01-16,0,6
99999.0,8223018,60,60,48,48,2023-01-10,2023-01-17,0,7
99999.0,8223018,264,264,48,48,2023-01-10,2023-02-15,0,36
99999.0,8223018,160,160,48,48,2023-01-10,2023-01-27,0,17
99999.0,8223018,84,84,48,48,2023-01-10,2023-02-23,0,44
99999.0,8223018,124,124,48,48,2023-01-10,2023-03-01,0,50
99999.0,8223018,140,140,48,48,2023-01-10,2023-02-09,0,30
99999.0,8223018,60,60,48,48,2023-01-10,2023-02-10,0,31
99999.0,8223018,72,72,48,48,2023-01-10,2023-02-21,0,42
99999.0,8223018,60,60,48,48,2023-01-10,2023-02-23,0,44
99999.0,8223018,156,156,48,48,2023-01-10,2023-03-08,0,57
99999.0,8223018,480,480,264,264,2023-02-15,2023-02-21,0,6
99999.0,8223018,2876,2876,160,160,2023-01-27,2023-02-01,0,5
99999.0,8223018,160,160,160,160,2023-01-27,2023-03-14,0,46
99999.0,8223018,200,200,160,160,2023-01-27,2023-02-28,0,32
99999.0,8223018,480,480,160,160,2023-01-27,2023-02-21,0,25
99999.0,8223018,264,264,160,160,2023-01-27,2023-02-15,0,19
99999.0,8223018,160,160,84,84,2023-02-23,2023-03-14,0,19
99999.0,8223018,200,200,84,84,2023-02-23,2023-02-28,0,5
99999.0,8223018,144,144,84,84,2023-02-23,2023-03-13,0,18
99999.0,8223018,124,124,84,84,2023-02-23,2023-03-01,0,6
99999.0,8223018,156,156,84,84,2023-02-23,2023-03-08,0,13
99999.0,8223018,160,160,32,32,2023-03-07,2023-03-14,0,7
99999.0,8223018,144,144,32,32,2023-03-07,2023-03-13,0,6
99999.0,8223018,72,72,32,32,2023-03-07,2023-03-13,0,6
99999.0,8223018,60,60,32,32,2023-03-07,2023-03-27,0,20
99999.0,8223018,156,156,32,32,2023-03-07,2023-03-08,0,1
99999.0,8223018,160,160,144,144,2023-03-13,2023-03-14,0,1
99999.0,8223018,160,160,124,124,2023-03-01,2023-03-14,0,13
99999.0,8223018,144,144,124,124,2023-03-01,2023-03-13,0,12
99999.0,8223018,156,156,124,124,2023-03-01,2023-03-08,0,7
99999.0,8223018,160,160,12,12,2023-02-27,2023-03-14,0,15
99999.0,8223018,200,200,12,12,2023-02-27,2023-02-28,0,1
99999.0,8223018,32,32,12,12,2023-02-27,2023-03-07,0,8
99999.0,8223018,144,144,12,12,2023-02-27,2023-03-13,0,14
99999.0,8223018,124,124,12,12,2023-02-27,2023-03-01,0,2
99999.0,8223018,72,72,12,12,2023-02-27,2023-03-13,0,14
99999.0,8223018,60,60,12,12,2023-02-27,2023-03-27,0,28
99999.0,8223018,156,156,12,12,2023-02-27,2023-03-08,0,9
99999.0,8223018,160,160,140,140,2023-02-09,2023-03-14,0,33
99999.0,8223018,200,200,140,140,2023-02-09,2023-02-28,0,19
99999.0,8223018,480,480,140,140,2023-02-09,2023-02-21,0,12
99999.0,8223018,264,264,140,140,2023-02-09,2023-02-15,0,6
99999.0,8223018,144,144,140,140,2023-02-09,2023-03-13,0,32
99999.0,8223018,156,156,140,140,2023-02-09,2023-03-08,0,27
99999.0,8223018,160,160,60,60,2023-02-10,2023-03-14,0,32
99999.0,8223018,200,200,60,60,2023-02-10,2023-02-28,0,18
99999.0,8223018,480,480,60,60,2023-02-10,2023-02-21,0,11
99999.0,8223018,120,120,60,60,2023-02-10,2023-02-13,0,3
99999.0,8223018,264,264,60,60,2023-02-10,2023-02-15,0,5
99999.0,8223018,84,84,60,60,2023-02-10,2023-02-23,0,13
99999.0,8223018,144,144,60,60,2023-02-10,2023-03-13,0,31
99999.0,8223018,124,124,60,60,2023-02-10,2023-03-01,0,19
99999.0,8223018,72,72,60,60,2023-02-10,2023-03-13,0,31
99999.0,8223018,72,72,60,60,2023-02-10,2023-02-21,0,11
99999.0,8223018,60,60,60,60,2023-02-10,2023-02-23,0,13
99999.0,8223018,60,60,60,60,2023-02-10,2023-03-27,0,45
99999.0,8223018,156,156,60,60,2023-02-10,2023-03-08,0,26
99999.0,8223018,160,160,72,72,2023-03-13,2023-03-14,0,1
99999.0,8223018,160,160,72,72,2023-02-21,2023-03-14,0,21
99999.0,8223018,200,200,72,72,2023-02-21,2023-02-28,0,7
99999.0,8223018,84,84,72,72,2023-02-21,2023-02-23,0,2
99999.0,8223018,144,144,72,72,2023-02-21,2023-03-13,0,20
99999.0,8223018,124,124,72,72,2023-02-21,2023-03-01,0,8
99999.0,8223018,72,72,72,72,2023-02-21,2023-03-13,0,20
99999.0,8223018,156,156,72,72,2023-02-21,2023-03-08,0,15
99999.0,8223018,160,160,60,60,2023-02-23,2023-03-14,0,19
99999.0,8223018,200,200,60,60,2023-02-23,2023-02-28,0,5
99999.0,8223018,144,144,60,60,2023-02-23,2023-03-13,0,18
99999.0,8223018,124,124,60,60,2023-02-23,2023-03-01,0,6
99999.0,8223018,72,72,60,60,2023-02-23,2023-03-13,0,18
99999.0,8223018,60,60,60,60,2023-02-23,2023-03-27,0,32
99999.0,8223018,156,156,60,60,2023-02-23,2023-03-08,0,13
99999.0,8223018,160,160,156,156,2023-03-08,2023-03-14,0,6
99999.0,8224016,12,12,12,12,2022-12-15,2023-02-10,0,57
99999.0,8224016,8,8,4,4,2023-01-12,2023-02-21,0,40
99999.0,8224016,4,4,4,4,2023-01-12,2023-03-13,0,60
99999.0,8224016,12,12,4,4,2023-01-12,2023-02-10,0,29
99999.0,8224016,8,8,4,4,2023-01-12,2023-03-13,0,60
99999.0,8224016,8,8,4,4,2023-01-12,2023-02-21,0,40
99999.0,8224016,8,8,8,8,2023-02-21,2023-03-13,0,20
99999.0,8224016,4,4,4,4,2023-01-10,2023-01-12,0,2
99999.0,8224016,8,8,4,4,2023-01-10,2023-02-21,0,42
99999.0,8224016,12,12,4,4,2023-01-10,2023-02-10,0,31
99999.0,8224016,8,8,4,4,2023-01-10,2023-02-21,0,42
99999.0,8224016,8,8,8,8,2023-02-21,2023-03-13,0,20
99999.0,8225014,4,4,6,0,2022-11-14,2023-01-09,6,56
99999.0,8225014,10,10,4,4,2023-02-10,2023-02-15,0,5
99999.0,8225014,24,24,4,4,2023-02-10,2023-02-21,0,11
99999.0,8225014,10,10,4,4,2023-02-10,2023-02-13,0,3
99999.0,8225014,4,4,4,4,2023-02-10,2023-03-13,0,31
99999.0,8225014,8,8,4,4,2023-02-10,2023-03-01,0,19
99999.0,8225014,12,12,4,4,2023-02-10,2023-02-21,0,11
99999.0,8225014,24,24,10,10,2023-02-15,2023-02-21,0,6
99999.0,8225014,12,12,10,10,2023-02-15,2023-02-21,0,6
99999.0,8225014,4,4,4,4,2023-01-09,2023-02-10,0,32
99999.0,8225014,10,10,4,4,2023-01-09,2023-02-15,0,37
99999.0,8225014,24,24,4,4,2023-01-09,2023-02-21,0,43
99999.0,8225014,10,10,4,4,2023-01-09,2023-02-13,0,35
99999.0,8225014,4,4,4,4,2023-01-09,2023-01-27,0,18
99999.0,8225014,8,8,4,4,2023-01-09,2023-03-01,0,51
99999.0,8225014,4,4,4,4,2023-01-09,2023-02-09,0,31
99999.0,8225014,12,12,4,4,2023-01-09,2023-02-21,0,43
99999.0,8225014,10,10,10,10,2023-02-13,2023-02-15,0,2
99999.0,8225014,24,24,10,10,2023-02-13,2023-02-21,0,8
99999.0,8225014,12,12,10,10,2023-02-13,2023-02-21,0,8
99999.0,8225014,4,4,4,4,2023-01-27,2023-02-10,0,14
99999.0,8225014,10,10,4,4,2023-01-27,2023-02-15,0,19
99999.0,8225014,24,24,4,4,2023-01-27,2023-02-21,0,25
99999.0,8225014,10,10,4,4,2023-01-27,2023-02-13,0,17
99999.0,8225014,4,4,4,4,2023-01-27,2023-03-13,0,45
99999.0,8225014,8,8,4,4,2023-01-27,2023-03-01,0,33
99999.0,8225014,4,4,4,4,2023-01-27,2023-02-09,0,13
99999.0,8225014,12,12,4,4,2023-01-27,2023-02-21,0,25
99999.0,8225014,4,4,4,4,2023-02-09,2023-02-10,0,1
99999.0,8225014,10,10,4,4,2023-02-09,2023-02-15,0,6
99999.0,8225014,24,24,4,4,2023-02-09,2023-02-21,0,12
99999.0,8225014,10,10,4,4,2023-02-09,2023-02-13,0,4
99999.0,8225014,4,4,4,4,2023-02-09,2023-03-13,0,32
99999.0,8225014,8,8,4,4,2023-02-09,2023-03-01,0,20
99999.0,8225014,12,12,4,4,2023-02-09,2023-02-21,0,12
99999.0,8226012,120,0,48,48,2022-12-15,2023-01-19,0,35
99999.0,8226012,120,120,48,48,2022-12-15,2023-01-19,0,35
99999.0,8226012,60,60,48,48,2022-12-15,2023-01-17,0,33
99999.0,8226012,48,48,12,12,2022-12-05,2022-12-15,0,10
99999.0,8226012,24,24,12,12,2022-12-05,2022-12-20,0,15
99999.0,8226012,12,12,12,12,2022-12-05,2022-12-15,0,10
99999.0,8226012,12,12,12,12,2022-12-05,2023-01-18,0,44
99999.0,8226012,120,0,12,12,2022-12-05,2023-01-19,0,45
99999.0,8226012,120,120,12,12,2022-12-05,2023-01-19,0,45
99999.0,8226012,60,60,12,12,2022-12-05,2023-01-17,0,43
99999.0,8226012,12,12,12,12,2022-12-05,2023-01-10,0,36
99999.0,8226012,120,0,24,24,2022-12-20,2023-01-19,0,30
99999.0,8226012,120,120,24,24,2022-12-20,2023-01-19,0,30
99999.0,8226012,60,60,24,24,2022-12-20,2023-01-17,0,28
99999.0,8226012,24,24,12,12,2022-12-15,2022-12-20,0,5
99999.0,8226012,12,12,12,12,2022-12-15,2023-01-18,0,34
99999.0,8226012,120,0,12,12,2022-12-15,2023-01-19,0,35
99999.0,8226012,120,120,12,12,2022-12-15,2023-01-19,0,35
99999.0,8226012,60,60,12,12,2022-12-15,2023-01-17,0,33
99999.0,8226012,12,12,12,12,2022-12-15,2023-01-10,0,26
99999.0,8226012,120,0,12,12,2023-01-18,2023-01-19,0,1
99999.0,8226012,120,120,12,12,2023-01-18,2023-01-19,0,1
99999.0,8226012,12,12,12,12,2023-01-18,2023-02-23,0,36
99999.0,8226012,24,24,12,12,2023-01-18,2023-03-01,0,42
99999.0,8226012,12,12,12,12,2023-01-18,2023-02-27,0,40
99999.0,8226012,12,12,120,0,2023-01-19,2023-02-23,120,35
99999.0,8226012,24,24,120,0,2023-01-19,2023-03-01,120,41
99999.0,8226012,12,12,120,0,2023-01-19,2023-02-27,120,39
99999.0,8226012,120,0,60,60,2023-01-17,2023-01-19,0,2
99999.0,8226012,120,120,60,60,2023-01-17,2023-01-19,0,2
99999.0,8226012,12,12,12,12,2023-01-10,2023-01-18,0,8
99999.0,8226012,120,0,12,12,2023-01-10,2023-01-19,0,9
99999.0,8226012,120,120,12,12,2023-01-10,2023-01-19,0,9
99999.0,8226012,60,60,12,12,2023-01-10,2023-01-17,0,7
99999.0,8226012,12,12,12,12,2023-01-10,2023-02-23,0,44
99999.0,8226012,24,24,12,12,2023-01-10,2023-03-01,0,50
99999.0,8226012,12,12,12,12,2023-01-10,2023-02-27,0,48
99999.0,8226012,24,24,12,12,2023-02-23,2023-03-01,0,6
99999.0,8226012,12,12,12,12,2023-02-23,2023-02-27,0,4
99999.0,8226012,132,132,12,12,2023-02-23,2023-03-21,0,26
99999.0,8226012,132,132,24,24,2023-03-01,2023-03-21,0,20
99999.0,8226012,24,24,12,12,2023-02-27,2023-03-01,0,2
99999.0,8226012,132,132,12,12,2023-02-27,2023-03-21,0,22
99999.0,8227010,144,144,60,60,2022-12-15,2023-01-16,0,32
99999.0,8227010,60,60,6,0,2022-11-14,2022-12-15,6,31
99999.0,8227010,20,20,6,0,2022-11-14,2022-12-20,6,36
99999.0,8227010,12,12,6,0,2022-11-14,2023-01-12,6,59
99999.0,8227010,4,4,6,0,2022-11-14,2023-01-10,6,57
99999.0,8227010,4,4,6,0,2022-11-14,2023-01-13,6,60
99999.0,8227010,12,12,6,0,2022-11-14,2023-01-12,6,59
99999.0,8227010,24,24,20,20,2022-12-20,2023-02-10,0,52
99999.0,8227010,144,144,20,20,2022-12-20,2023-01-16,0,27
99999.0,8227010,24,24,20,20,2022-12-20,2023-01-27,0,38
99999.0,8227010,64,64,24,24,2023-02-10,2023-02-28,0,18
99999.0,8227010,24,24,24,24,2023-02-10,2023-02-21,0,11
99999.0,8227010,64,64,1,1,2023-02-15,2023-02-28,0,13
99999.0,8227010,24,24,1,1,2023-02-15,2023-02-21,0,6
99999.0,8227010,12,12,1,1,2023-02-15,2023-02-22,0,7
99999.0,8227010,8,8,1,1,2023-02-15,2023-02-23,0,8
99999.0,8227010,12,12,1,1,2023-02-15,2023-02-27,0,12
99999.0,8227010,4,4,1,1,2023-02-15,2023-03-13,0,26
99999.0,8227010,24,24,12,12,2023-01-12,2023-02-10,0,29
99999.0,8227010,64,64,12,12,2023-01-12,2023-02-28,0,47
99999.0,8227010,24,24,12,12,2023-01-12,2023-02-21,0,40
99999.0,8227010,12,12,12,12,2023-01-12,2023-02-14,0,33
99999.0,8227010,15,15,12,12,2023-01-12,2023-02-13,0,32
99999.0,8227010,144,144,12,12,2023-01-12,2023-01-16,0,4
99999.0,8227010,12,0,12,12,2023-01-12,2023-02-15,0,34
99999.0,8227010,12,12,12,12,2023-01-12,2023-02-22,0,41
99999.0,8227010,24,24,12,12,2023-01-12,2023-01-27,0,15
99999.0,8227010,12,12,12,12,2023-01-12,2023-02-09,0,28
99999.0,8227010,12,12,12,12,2023-01-12,2023-02-27,0,46
99999.0,8227010,64,64,24,24,2023-02-21,2023-02-28,0,7
99999.0,8227010,64,64,12,12,2023-02-14,2023-02-28,0,14
99999.0,8227010,24,24,12,12,2023-02-14,2023-02-21,0,7
99999.0,8227010,12,0,12,12,2023-02-14,2023-02-15,0,1
99999.0,8227010,12,12,12,12,2023-02-14,2023-02-22,0,8
99999.0,8227010,12,12,12,12,2023-02-14,2023-02-27,0,13
99999.0,8227010,64,64,15,15,2023-02-13,2023-02-28,0,15
99999.0,8227010,24,24,15,15,2023-02-13,2023-02-21,0,8
99999.0,8227010,24,24,4,4,2023-01-10,2023-02-10,0,31
99999.0,8227010,12,12,4,4,2023-01-10,2023-01-12,0,2
99999.0,8227010,64,64,4,4,2023-01-10,2023-02-28,0,49
99999.0,8227010,24,24,4,4,2023-01-10,2023-02-21,0,42
99999.0,8227010,12,12,4,4,2023-01-10,2023-02-14,0,35
99999.0,8227010,15,15,4,4,2023-01-10,2023-02-13,0,34
99999.0,8227010,144,144,4,4,2023-01-10,2023-01-16,0,6
99999.0,8227010,12,0,4,4,2023-01-10,2023-02-15,0,36
99999.0,8227010,12,12,4,4,2023-01-10,2023-02-22,0,43
99999.0,8227010,4,4,4,4,2023-01-10,2023-01-13,0,3
99999.0,8227010,8,8,4,4,2023-01-10,2023-02-23,0,44
99999.0,8227010,24,24,4,4,2023-01-10,2023-01-27,0,17
99999.0,8227010,12,12,4,4,2023-01-10,2023-02-09,0,30
99999.0,8227010,12,12,4,4,2023-01-10,2023-01-12,0,2
99999.0,8227010,12,12,4,4,2023-01-10,2023-02-27,0,48
99999.0,8227010,64,64,12,0,2023-02-15,2023-02-28,12,13
99999.0,8227010,24,24,12,0,2023-02-15,2023-02-21,12,6
99999.0,8227010,12,12,12,0,2023-02-15,2023-02-22,12,7
99999.0,8227010,8,8,12,0,2023-02-15,2023-02-23,12,8
99999.0,8227010,12,12,12,0,2023-02-15,2023-02-27,12,12
99999.0,8227010,4,4,12,0,2023-02-15,2023-03-13,12,26
99999.0,8227010,64,64,12,12,2023-02-22,2023-02-28,0,6
99999.0,8227010,12,12,12,12,2023-02-22,2023-02-27,0,5
99999.0,8227010,24,24,4,4,2023-01-13,2023-02-10,0,28
99999.0,8227010,64,64,4,4,2023-01-13,2023-02-28,0,46
99999.0,8227010,24,24,4,4,2023-01-13,2023-02-21,0,39
99999.0,8227010,12,12,4,4,2023-01-13,2023-02-14,0,32
99999.0,8227010,15,15,4,4,2023-01-13,2023-02-13,0,31
99999.0,8227010,144,144,4,4,2023-01-13,2023-01-16,0,3
99999.0,8227010,12,0,4,4,2023-01-13,2023-02-15,0,33
99999.0,8227010,12,12,4,4,2023-01-13,2023-02-22,0,40
99999.0,8227010,8,8,4,4,2023-01-13,2023-02-23,0,41
99999.0,8227010,24,24,4,4,2023-01-13,2023-01-27,0,14
99999.0,8227010,12,12,4,4,2023-01-13,2023-02-09,0,27
99999.0,8227010,12,12,4,4,2023-01-13,2023-02-27,0,45
99999.0,8227010,4,4,4,4,2023-01-13,2023-03-13,0,59
99999.0,8227010,64,64,8,8,2023-02-23,2023-02-28,0,5
99999.0,8227010,12,12,8,8,2023-02-23,2023-02-27,0,4
99999.0,8227010,24,24,24,24,2023-01-27,2023-02-10,0,14
99999.0,8227010,64,64,24,24,2023-01-27,2023-02-28,0,32
99999.0,8227010,24,24,24,24,2023-01-27,2023-02-21,0,25
99999.0,8227010,24,24,12,12,2023-02-09,2023-02-10,0,1
99999.0,8227010,64,64,12,12,2023-02-09,2023-02-28,0,19
99999.0,8227010,24,24,12,12,2023-02-09,2023-02-21,0,12
99999.0,8227010,12,12,12,12,2023-02-09,2023-02-14,0,5
99999.0,8227010,15,15,12,12,2023-02-09,2023-02-13,0,4
99999.0,8227010,12,0,12,12,2023-02-09,2023-02-15,0,6
99999.0,8227010,12,12,12,12,2023-02-09,2023-02-22,0,13
99999.0,8227010,12,12,12,12,2023-02-09,2023-02-27,0,18
99999.0,8227010,24,24,12,12,2023-01-12,2023-02-10,0,29
99999.0,8227010,64,64,12,12,2023-01-12,2023-02-28,0,47
99999.0,8227010,24,24,12,12,2023-01-12,2023-02-21,0,40
99999.0,8227010,12,12,12,12,2023-01-12,2023-02-14,0,33
99999.0,8227010,15,15,12,12,2023-01-12,2023-02-13,0,32
99999.0,8227010,144,144,12,12,2023-01-12,2023-01-16,0,4
99999.0,8227010,12,0,12,12,2023-01-12,2023-02-15,0,34
99999.0,8227010,12,12,12,12,2023-01-12,2023-02-22,0,41
99999.0,8227010,24,24,12,12,2023-01-12,2023-01-27,0,15
99999.0,8227010,12,12,12,12,2023-01-12,2023-02-09,0,28
99999.0,8227010,12,12,12,12,2023-01-12,2023-02-27,0,46
99999.0,8227010,64,64,12,12,2023-02-27,2023-02-28,0,1
99999.0,8228018,6,6,4,4,2022-12-23,2023-02-10,0,49
99999.0,8228018,4,4,4,4,2022-12-23,2023-02-21,0,60
99999.0,8228018,4,4,4,4,2022-12-23,2023-01-10,0,18
99999.0,8228018,12,12,4,4,2022-12-23,2023-01-12,0,20
99999.0,8228018,104,104,4,4,2022-12-23,2023-02-17,0,56
99999.0,8228018,12,12,6,6,2022-11-14,2023-01-12,0,59
99999.0,8228018,48,48,6,6,2023-02-10,2023-02-28,0,18
99999.0,8228018,104,104,6,6,2023-02-10,2023-02-17,0,7
99999.0,8228018,48,48,4,4,2023-02-21,2023-02-28,0,7
99999.0,8228018,48,48,2,2,2023-02-13,2023-02-28,0,15
99999.0,8228018,4,4,2,2,2023-02-13,2023-02-21,0,8
99999.0,8228018,104,104,2,2,2023-02-13,2023-02-17,0,4
99999.0,8228018,6,6,4,4,2023-01-10,2023-02-10,0,31
99999.0,8228018,48,48,4,4,2023-01-10,2023-02-28,0,49
99999.0,8228018,4,4,4,4,2023-01-10,2023-02-21,0,42
99999.0,8228018,12,12,4,4,2023-01-10,2023-01-12,0,2
99999.0,8228018,104,104,4,4,2023-01-10,2023-02-17,0,38
99999.0,8228018,48,48,12,12,2023-01-12,2023-02-28,0,47
99999.0,8228018,104,104,12,12,2023-01-12,2023-02-17,0,36
99999.0,8230013,120,120,12,12,2022-12-20,2023-02-17,0,59
99999.0,8231011,4,4,4,4,2023-01-12,2023-02-15,0,34
99999.0,8231011,4,4,4,4,2023-01-12,2023-02-27,0,46
99999.0,8231011,4,4,4,4,2023-01-12,2023-02-09,0,28
99999.0,8231011,8,8,4,4,2023-02-15,2023-03-14,0,27
99999.0,8231011,4,4,4,4,2023-02-15,2023-02-27,0,12
99999.0,8231011,4,4,4,4,2023-01-10,2023-01-12,0,2
99999.0,8231011,4,4,4,4,2023-01-10,2023-02-15,0,36
99999.0,8231011,4,4,4,4,2023-01-10,2023-02-27,0,48
99999.0,8231011,4,4,4,4,2023-01-10,2023-02-09,0,30
99999.0,8231011,8,8,4,4,2023-02-27,2023-03-14,0,15
99999.0,8231011,8,8,4,4,2023-02-09,2023-03-14,0,33
99999.0,8231011,4,4,4,4,2023-02-09,2023-02-15,0,6
99999.0,8231011,4,4,4,4,2023-02-09,2023-02-27,0,18
99999.0,8232019,20,20,20,0,2023-02-23,2023-02-28,20,5
99999.0,8234015,12,12,12,0,2023-02-23,2023-02-28,12,5
99999.0,8666408,1,1,15,0,2022-11-23,2023-01-05,15,43
99999.0,8717714,10,10,2,2,2022-12-25,2023-02-21,0,58
99999.0,8717714,4,4,2,2,2022-12-25,2023-01-31,0,37
99999.0,8717714,3,3,2,2,2022-12-25,2023-01-20,0,26
99999.0,8717714,10,10,1,1,2023-01-13,2023-02-21,0,39
99999.0,8717714,4,4,1,1,2023-01-13,2023-01-31,0,18
99999.0,8717714,3,3,1,1,2023-01-13,2023-01-20,0,7
99999.0,8717714,3,3,1,1,2023-01-13,2023-03-05,0,51
99999.0,8717714,10,10,4,4,2023-01-31,2023-02-21,0,21
99999.0,8717714,10,10,3,3,2023-01-20,2023-02-21,0,32
99999.0,8717714,4,4,3,3,2023-01-20,2023-01-31,0,11
99999.0,8717714,3,3,3,3,2023-01-20,2023-03-05,0,44
99999.0,8720774,4,4,4,4,2023-01-31,2023-02-13,0,13
99999.0,8720790,40,40,5,5,2022-12-30,2023-01-03,0,4
99999.0,8720790,8,8,5,5,2022-12-30,2023-01-26,0,27
99999.0,8720790,14,14,5,5,2022-12-30,2023-01-31,0,32
99999.0,8720790,40,40,5,5,2022-12-30,2023-02-13,0,45
99999.0,8720790,40,40,40,40,2023-01-03,2023-02-13,0,41
99999.0,8720790,14,14,8,8,2023-01-26,2023-01-31,0,5
99999.0,8720790,40,40,8,8,2023-01-26,2023-02-13,0,18
99999.0,8720790,29,29,8,8,2023-01-26,2023-03-05,0,38
99999.0,8720790,12,12,8,8,2023-01-26,2023-03-01,0,34
99999.0,8720790,40,40,14,14,2023-01-31,2023-02-13,0,13
99999.0,8720790,29,29,14,14,2023-01-31,2023-03-05,0,33
99999.0,8720790,40,40,4,4,2023-02-08,2023-02-13,0,5
99999.0,8720790,29,29,4,4,2023-02-08,2023-03-05,0,25
99999.0,8720790,12,12,4,4,2023-02-08,2023-03-01,0,21
99999.0,8720790,29,29,1,1,2023-03-02,2023-03-05,0,3
99999.0,8720790,8,8,1,1,2023-01-17,2023-01-26,0,9
99999.0,8720790,14,14,1,1,2023-01-17,2023-01-31,0,14
99999.0,8720790,4,4,1,1,2023-01-17,2023-02-08,0,22
99999.0,8720790,40,40,1,1,2023-01-17,2023-02-13,0,27
99999.0,8720790,1,1,1,1,2023-01-17,2023-03-02,0,44
99999.0,8720790,29,29,1,1,2023-01-17,2023-03-05,0,47
99999.0,8720790,12,12,1,1,2023-01-17,2023-03-01,0,43
99999.0,8720790,29,29,12,12,2023-03-01,2023-03-05,0,4
99999.0,8740012,6,6,3,3,2023-01-17,2023-01-31,0,14
99999.0,8740012,6,6,2,2,2023-01-20,2023-01-31,0,11
99999.0,9881013,1,1,1,1,2023-01-12,2023-03-09,0,56
99999.0,1AA0003,20,20,4,4,2022-12-30,2023-02-21,0,53
99999.0,1AA0003,10,10,4,4,2022-12-30,2023-01-18,0,19
99999.0,1AA0003,20,20,1,1,2023-02-06,2023-02-21,0,15
99999.0,1AA0003,3,3,1,1,2023-02-06,2023-03-22,0,44
99999.0,1AA0003,20,20,10,10,2023-01-18,2023-02-21,0,34
99999.0,1AA0004,4,4,2,2,2022-12-20,2023-01-11,0,22
99999.0,1AA0004,5,5,2,2,2022-12-20,2023-01-31,0,42
99999.0,1AA0004,4,4,2,2,2022-12-20,2023-01-24,0,35
99999.0,1AA0004,20,20,2,2,2022-12-20,2023-02-09,0,51
99999.0,1AA0004,30,30,2,2,2022-12-20,2023-01-18,0,29
99999.0,1AA0004,4,4,2,2,2022-12-20,2023-01-04,0,15
99999.0,1AA0004,180,180,30,30,2023-02-21,2023-02-24,0,3
99999.0,1AA0004,30,30,4,4,2023-01-11,2023-02-21,0,41
99999.0,1AA0004,5,5,4,4,2023-01-11,2023-01-31,0,20
99999.0,1AA0004,4,4,4,4,2023-01-11,2023-01-24,0,13
99999.0,1AA0004,20,20,4,4,2023-01-11,2023-02-09,0,29
99999.0,1AA0004,30,30,4,4,2023-01-11,2023-01-18,0,7
99999.0,1AA0004,12,12,4,4,2023-01-11,2023-03-02,0,50
99999.0,1AA0004,180,180,4,4,2023-01-11,2023-02-24,0,44
99999.0,1AA0004,30,30,5,5,2023-01-31,2023-02-21,0,21
99999.0,1AA0004,20,20,5,5,2023-01-31,2023-02-09,0,9
99999.0,1AA0004,12,12,5,5,2023-01-31,2023-03-02,0,30
99999.0,1AA0004,180,180,5,5,2023-01-31,2023-02-24,0,24
99999.0,1AA0004,30,30,1,1,2023-01-17,2023-02-21,0,35
99999.0,1AA0004,5,5,1,1,2023-01-17,2023-01-31,0,14
99999.0,1AA0004,4,4,1,1,2023-01-17,2023-01-24,0,7
99999.0,1AA0004,1,1,1,1,2023-01-17,2023-02-06,0,20
99999.0,1AA0004,3,3,1,1,2023-01-17,2023-03-10,0,52
99999.0,1AA0004,20,20,1,1,2023-01-17,2023-02-09,0,23
99999.0,1AA0004,30,30,1,1,2023-01-17,2023-01-18,0,1
99999.0,1AA0004,12,12,1,1,2023-01-17,2023-03-02,0,44
99999.0,1AA0004,180,180,1,1,2023-01-17,2023-02-24,0,38
99999.0,1AA0004,30,30,4,4,2023-01-24,2023-02-21,0,28
99999.0,1AA0004,5,5,4,4,2023-01-24,2023-01-31,0,7
99999.0,1AA0004,20,20,4,4,2023-01-24,2023-02-09,0,16
99999.0,1AA0004,12,12,4,4,2023-01-24,2023-03-02,0,37
99999.0,1AA0004,180,180,4,4,2023-01-24,2023-02-24,0,31
99999.0,1AA0004,30,30,1,1,2023-02-06,2023-02-21,0,15
99999.0,1AA0004,3,3,1,1,2023-02-06,2023-03-10,0,32
99999.0,1AA0004,20,20,1,1,2023-02-06,2023-02-09,0,3
99999.0,1AA0004,12,12,1,1,2023-02-06,2023-03-02,0,24
99999.0,1AA0004,180,180,1,1,2023-02-06,2023-02-24,0,18
99999.0,1AA0004,30,30,20,20,2023-02-09,2023-02-21,0,12
99999.0,1AA0004,180,180,20,20,2023-02-09,2023-02-24,0,15
99999.0,1AA0004,30,30,30,30,2023-01-18,2023-02-21,0,34
99999.0,1AA0004,180,180,30,30,2023-01-18,2023-02-24,0,37
99999.0,1AA0004,30,30,4,4,2023-01-04,2023-02-21,0,48
99999.0,1AA0004,4,4,4,4,2023-01-04,2023-01-11,0,7
99999.0,1AA0004,5,5,4,4,2023-01-04,2023-01-31,0,27
99999.0,1AA0004,4,4,4,4,2023-01-04,2023-01-24,0,20
99999.0,1AA0004,20,20,4,4,2023-01-04,2023-02-09,0,36
99999.0,1AA0004,30,30,4,4,2023-01-04,2023-01-18,0,14
99999.0,1AA0004,12,12,4,4,2023-01-04,2023-03-02,0,57
99999.0,1AA0004,180,180,4,4,2023-01-04,2023-02-24,0,51
99999.0,1AB2190,2,2,2,0,2023-03-07,2023-03-08,2,1
99999.0,1AB2692,120,120,100,100,2023-01-18,2023-02-24,0,37
99999.0,1AB2733,6,6,5,5,2022-11-28,2022-12-19,0,21
99999.0,1AB2733,6,6,2,2,2022-12-08,2022-12-19,0,11
99999.0,1AB2733,3,3,2,2,2022-12-08,2023-01-17,0,40
99999.0,1AB2733,2,2,2,2,2022-12-08,2023-01-26,0,49
99999.0,1AB2733,3,3,2,2,2022-12-08,2023-01-26,0,49
99999.0,1AB2733,1,1,1,1,2023-01-18,2023-02-01,0,14
99999.0,1AB2733,2,2,1,1,2023-01-18,2023-01-26,0,8
99999.0,1AB2733,3,3,1,1,2023-01-18,2023-01-26,0,8
99999.0,1AB2733,1,1,1,1,2023-01-18,2023-03-01,0,42
99999.0,1AB2733,3,3,1,1,2023-01-18,2023-03-01,0,42
99999.0,1AB2733,6,6,1,1,2023-01-18,2023-03-01,0,42
99999.0,1AB2733,1,1,1,1,2023-01-18,2023-02-07,0,20
99999.0,1AB2733,3,3,3,3,2023-01-17,2023-01-26,0,9
99999.0,1AB2733,3,3,3,3,2023-01-17,2023-03-01,0,43
99999.0,1AB2733,6,6,3,3,2023-01-17,2023-03-01,0,43
99999.0,1AB2733,1,1,1,1,2023-02-01,2023-03-01,0,28
99999.0,1AB2733,3,3,1,1,2023-02-01,2023-03-01,0,28
99999.0,1AB2733,6,6,1,1,2023-02-01,2023-03-01,0,28
99999.0,1AB2733,1,1,1,1,2023-02-01,2023-02-07,0,6
99999.0,1AB2733,3,3,2,2,2023-01-26,2023-03-01,0,34
99999.0,1AB2733,6,6,2,2,2023-01-26,2023-03-01,0,34
99999.0,1AB2733,3,3,3,3,2023-01-26,2023-03-01,0,34
99999.0,1AB2733,6,6,3,3,2023-01-26,2023-03-01,0,34
99999.0,1AB2733,1,1,1,1,2023-02-07,2023-03-01,0,22
99999.0,1AB2733,3,3,1,1,2023-02-07,2023-03-01,0,22
99999.0,1AB2733,6,6,1,1,2023-02-07,2023-03-01,0,22
99999.0,1AB2735,2,2,2,2,2023-01-26,2023-02-07,0,12
99999.0,1AB4571,20,20,2,2,2023-01-26,2023-03-01,0,34
